State_name,District_name,Population,Male,Female,Literate,Male_Literate,Female_Literate,Households,Workers,Main_Workers,Marginal_Workers,Sex_Ratio,Literacy_Rate,Male_Literacy_Rate,Female_Literacy_Rate
JAMMU AND KASHMIR,Kupwara,870354,474190,396164,439654,282823,156831,181664,229064,123837,105227,835.4541428541302,50.51,59.64,39.59
JAMMU AND KASHMIR,Badgam,753745,398041,355704,335649,207741,127908,187839,214866,132003,82863,893.636585175899,44.53,52.19,35.96
JAMMU AND KASHMIR,Leh(Ladakh),133487,78971,54516,93770,62834,30936,54394,75079,57125,17954,690.329361411151,70.25,79.57,56.75
JAMMU AND KASHMIR,Kargil,140802,77785,63017,86236,56301,29935,48144,51873,28941,22932,810.1433438323584,61.25,72.38,47.5
JAMMU AND KASHMIR,Punch,476835,251899,224936,261724,163333,98391,147408,161393,73247,88146,892.9610677295266,54.89,64.84,43.74
JAMMU AND KASHMIR,Rajouri,642415,345351,297064,364109,224469,139640,213578,290912,130377,160535,860.1799328798816,56.68,65.0,47.01
JAMMU AND KASHMIR,Kathua,616435,326109,290326,389204,228499,160705,214847,200431,142847,57584,890.2728842196934,63.14,70.07,55.35
JAMMU AND KASHMIR,Baramula,1008039,534733,473306,545149,337170,207979,259475,304200,187959,116241,885.1258478530407,54.08,63.05,43.94
JAMMU AND KASHMIR,Bandipore,392232,207680,184552,185979,117058,68921,98076,149317,75173,74144,888.6363636363636,47.42,56.36,37.35
JAMMU AND KASHMIR,Srinagar,1236829,651124,585705,748584,431746,316838,262239,407188,330547,76641,899.5291219491219,60.52,66.31,54.1
JAMMU AND KASHMIR,Ganderbal,297446,158720,138726,143276,90581,52695,77346,100890,52949,47941,874.0297379032259,48.17,57.07,37.98
JAMMU AND KASHMIR,Pulwama,560440,293064,267376,293958,178326,115632,169223,188420,98306,90114,912.3467911445964,52.45,60.85,43.25
JAMMU AND KASHMIR,Shupiyan,266215,136480,129735,136500,80355,56145,80888,87721,54703,33018,950.5788393903869,51.27,58.88,43.28
JAMMU AND KASHMIR,Anantnag,1078692,559767,518925,545532,324417,221115,277733,389684,176800,212884,927.0374995310549,50.57,57.96,42.61
JAMMU AND KASHMIR,Kulgam,424483,217620,206863,209085,125052,84033,121130,159990,77812,82178,950.5698005698006,49.26,57.46,40.62
JAMMU AND KASHMIR,Doda,409936,213641,196295,219083,138620,80463,133617,151912,79377,72535,918.8077194920451,53.44,64.88,40.99
JAMMU AND KASHMIR,Ramban,283713,149132,134581,124065,82938,41127,89622,87212,52051,35161,902.4287208647372,43.73,55.61,30.56
JAMMU AND KASHMIR,Kishtwar,230696,120165,110531,107506,68700,38806,78371,82974,44718,38256,919.8269046727416,46.6,57.17,35.11
JAMMU AND KASHMIR,Udhampur,554985,296784,258201,322354,197543,124811,183360,243672,152442,91230,869.9963609898108,58.08,66.56,48.34
JAMMU AND KASHMIR,Reasi,314667,166461,148206,150542,93937,56605,107833,144767,88462,56305,890.3346729864653,47.84,56.43,38.19
JAMMU AND KASHMIR,Jammu,1529958,813821,716137,1137135,641916,495219,502609,508622,410344,98278,879.9686909037737,74.32,78.88,69.15
JAMMU AND KASHMIR,Samba,318898,169124,149774,228139,130312,97827,114236,92526,74129,18397,885.5869066483764,71.54,77.05,65.32
HIMACHAL PRADESH,Chamba,519080,261320,257760,323842,186064,137778,200231,294035,119632,174403,986.3768559620388,62.39,71.2,53.45
HIMACHAL PRADESH,Kangra,1510075,750591,759484,1152640,606443,546197,627328,675170,313915,361255,1011.8479971116094,76.33,80.8,71.92
HIMACHAL PRADESH,Lahul AND Spiti,31564,16588,14976,21845,12897,8948,17434,19295,15190,4105,902.8213166144201,69.21,77.75,59.75
HIMACHAL PRADESH,Kullu,437903,225452,212451,307672,174550,133122,188704,269084,193876,75208,942.3336231215513,70.26,77.42,62.66
HIMACHAL PRADESH,Mandi,999777,498065,501712,723747,393669,330078,462825,572671,284154,288517,1007.3223374459157,72.39,79.04,65.79
HIMACHAL PRADESH,Hamirpur,454768,217070,237698,358091,180555,177536,211348,241931,126153,115778,1095.0292532362832,78.74,83.18,74.69
HIMACHAL PRADESH,Una,521173,263692,257481,399715,213281,186434,205217,215346,134482,80864,976.4460051878707,76.7,80.88,72.41
HIMACHAL PRADESH,Bilaspur,381956,192764,189192,287620,155599,132021,164445,205871,103406,102465,981.469569006661,75.3,80.72,69.78
HIMACHAL PRADESH,Solan,580320,308754,271566,428578,244372,184206,244296,298737,219235,79502,879.5545968635224,73.85,79.15,67.83
HIMACHAL PRADESH,Sirmaur,529855,276289,253566,362645,205617,157028,192156,280083,193906,86177,917.7564072402448,68.44,74.42,61.93
HIMACHAL PRADESH,Shimla,814010,425039,388971,612642,342846,269796,375165,430926,311770,119156,915.1419046252227,75.26,80.66,69.36
HIMACHAL PRADESH,Kinnaur,84121,46249,37872,60699,36697,24002,44514,56273,46782,9491,818.8717593893922,72.16,79.35,63.38
PUNJAB,Gurdaspur,2298323,1212617,1085706,1634719,907660,727059,606348,757138,625778,131360,895.3412330521509,71.13,74.85,66.97
PUNJAB,Kapurthala,815168,426311,388857,576567,316254,260313,261203,284165,248208,35957,912.1439512468596,70.73,74.18,66.94
PUNJAB,Jalandhar,2193590,1145211,1048379,1622537,882581,739956,708130,774472,689592,84880,915.4461492249027,73.97,77.07,70.58
PUNJAB,Hoshiarpur,1586625,809057,777568,1199699,637927,561772,551265,499822,411011,88811,961.0793800684006,75.61,78.85,72.25
PUNJAB,Shahid Bhagat Singh Nagar,612310,313291,299019,438459,239155,199304,231551,204329,173507,30822,954.4449090462223,71.61,76.34,66.65
PUNJAB,Fatehgarh Sahib,600163,320795,279368,426033,238696,187337,174896,214783,192845,21938,870.8614535762714,70.99,74.41,67.06
PUNJAB,Ludhiana,3498739,1867816,1630923,2560225,1428348,1131877,1036821,1284822,1138654,146168,873.1711260638093,73.18,76.47,69.4
PUNJAB,Moga,995746,525920,469826,627889,348549,279340,288439,359172,304880,54292,893.3411925768178,63.06,66.27,59.46
PUNJAB,Firozpur,2029074,1071637,957437,1227511,707070,520441,502390,756695,618362,138333,893.434063960091,60.5,65.98,54.36
PUNJAB,Muktsar,901896,475622,426274,524848,300401,224447,224157,335326,287205,48121,896.2453376841273,58.19,63.16,52.65
PUNJAB,Faridkot,617508,326671,290837,381285,215767,165518,158863,221555,190415,31140,890.3055367632878,61.75,66.05,56.91
PUNJAB,Bathinda,1388525,743197,645328,844868,488261,356607,355722,549986,452678,97308,868.313515797292,60.85,65.7,55.26
PUNJAB,Mansa,769751,408732,361019,423560,244037,179523,196389,328512,247175,81337,883.2658074239355,55.03,59.71,49.73
PUNJAB,Patiala,1895686,1002522,893164,1266791,711052,555739,517369,660267,570391,89876,890.9171070560049,66.82,70.93,62.22
PUNJAB,Amritsar,2490656,1318408,1172248,1684770,932981,751789,660953,917856,787254,130602,889.1390222146711,67.64,70.77,64.13
PUNJAB,Tarn Taran,1119627,589369,530258,666162,376427,289735,267174,380702,316310,64392,899.7045993257195,59.5,63.87,54.64
PUNJAB,Rupnagar,684627,357485,327142,502731,278534,224197,208699,233676,194209,39467,915.1209141642307,73.43,77.91,68.53
PUNJAB,Sahibzada Ajit Singh Nagar,994628,529253,465375,736575,409944,326631,291335,355995,316236,39759,879.3053605742433,74.06,77.46,70.19
PUNJAB,Sangrur,1655169,878029,777140,1002077,570413,431664,448944,568758,499792,68966,885.0960503582455,60.54,64.97,55.55
PUNJAB,Barnala,595527,317522,278005,359831,201999,157832,156799,209331,186434,22897,875.5456314838027,60.42,63.62,56.77
CHANDIGARH,Chandigarh,1055450,580663,474787,805438,465346,340092,298367,404136,385929,18207,817.6636017793454,76.31,80.14,71.63
UTTARAKHAND,Uttarkashi,330086,168597,161489,215126,128237,86889,121209,157276,128367,28909,957.8402937181563,65.17,76.06,53.8
UTTARAKHAND,Chamoli,391605,193991,197614,280556,155395,125161,186340,180940,115115,65825,1018.6761241500894,71.64,80.1,63.34
UTTARAKHAND,Rudraprayag,242285,114589,127696,170933,91803,79130,117159,113032,78950,34082,1114.3827068915864,70.55,80.12,61.97
UTTARAKHAND,Tehri Garhwal,618931,297986,320945,407994,227406,180588,254236,280442,165912,114530,1077.047243830247,65.92,76.31,56.27
UTTARAKHAND,Dehradun,1696694,892199,804495,1259506,702216,557290,497638,582768,488161,94607,901.6990604114104,74.23,78.71,69.27
UTTARAKHAND,Garhwal,687271,326829,360442,494889,262148,232741,316462,274152,164439,109713,1102.8458306943387,72.01,80.21,64.57
UTTARAKHAND,Pithoragarh,483439,239306,244133,345550,189623,155927,209943,216490,145481,71009,1020.1708273089685,71.48,79.24,63.87
UTTARAKHAND,Bageshwar,259898,124326,135572,179483,97546,81937,99911,123638,78085,45553,1090.4557373357143,69.06,78.46,60.44
UTTARAKHAND,Almora,622506,291081,331425,436497,231604,204893,281138,298211,201078,97133,1138.6005957104724,70.12,79.57,61.82
UTTARAKHAND,Champawat,259648,131125,128523,177726,102015,75711,98041,99566,62698,36868,980.1563393708293,68.45,77.8,58.91
UTTARAKHAND,Nainital,954605,493666,460939,696500,385779,310721,298663,376181,296424,79757,933.7061900151115,72.96,78.15,67.41
UTTARAKHAND,Udham Singh Nagar,1648902,858783,790119,1037839,598525,439314,414659,591458,450762,140696,920.0449939041644,62.94,69.69,55.6
UTTARAKHAND,Hardwar,1890422,1005295,885127,1178354,691411,486943,488011,578121,495152,82969,880.4649381524827,62.33,68.78,55.01
HARYANA,Panchkula,561293,299679,261614,405318,229862,175456,164551,211479,182831,28648,872.9807560756676,72.21,76.7,67.07
HARYANA,Ambala,1128350,598703,529647,818025,461288,356737,315256,372139,319475,52664,884.6573342709156,72.5,77.05,67.35
HARYANA,Yamunanagar,1214205,646718,567487,832457,474793,357664,357723,389233,339024,50209,877.4875602658345,68.56,73.42,63.03
HARYANA,Kurukshetra,964655,510976,453679,646893,370828,276065,291821,336780,285904,50876,887.8675319388778,67.06,72.57,60.85
HARYANA,Kaithal,1074304,571003,503301,646529,385782,260747,306787,373899,290663,83236,881.4331973737442,60.18,67.56,51.81
HARYANA,Karnal,1505324,797712,707612,978013,564516,413497,428602,516062,411533,104529,887.0519686302825,64.97,70.77,58.44
HARYANA,Panipat,1205437,646857,558580,786599,464136,322463,327306,412318,339016,73302,863.52934265224,65.25,71.75,57.73
HARYANA,Sonipat,1450001,781299,668702,998316,589881,408435,417434,523179,396763,126416,855.8848789003953,68.85,75.5,61.08
HARYANA,Jind,1334152,713006,621146,832758,502049,330709,368000,523422,385851,137571,871.1651795356561,62.42,70.41,53.24
HARYANA,Fatehabad,942011,495360,446651,557578,327471,230107,258380,369083,286258,82825,901.6694928940568,59.19,66.11,51.52
HARYANA,Sirsa,1295189,682582,612607,782897,456968,325929,338792,502003,399169,102834,897.4848443117456,60.45,66.95,53.2
HARYANA,Hisar,1743931,931562,812369,1114311,670200,444111,456126,691621,531227,160394,872.05038419343,63.9,71.94,54.67
HARYANA,Bhiwani,1634445,866672,767773,1069871,643158,426713,456282,623006,445675,177331,885.8864714678679,65.46,74.21,55.58
HARYANA,Rohtak,1061204,568479,492725,747582,436025,311557,306942,345967,288949,57018,866.7426589196787,70.45,76.7,63.23
HARYANA,Jhajjar,958405,514667,443738,676091,399480,276611,290144,326534,246457,80077,862.1846747508583,70.54,77.62,62.34
HARYANA,Mahendragarh,922088,486665,435423,630255,380440,249815,267942,338584,212402,126182,894.7078585885569,68.35,78.17,57.37
HARYANA,Rewari,900332,474335,425997,636947,375453,261494,268754,337727,250219,87508,898.0931198414622,70.75,79.15,61.38
HARYANA,Gurgaon,1514432,816690,697742,1111116,638666,472450,523691,544716,487441,57275,854.3535490822711,73.37,78.2,67.71
HARYANA,Mewat,1089263,571162,518101,454897,308435,146462,223635,289964,204178,85786,907.0999121089989,41.76,54.0,28.27
HARYANA,Faridabad,1809733,966110,843623,1272739,734940,537799,470681,579229,495316,83913,873.2163004212771,70.33,76.07,63.75
HARYANA,Palwal,1042708,554497,488211,599796,379696,220100,249159,309563,216932,92631,880.4574235748795,57.52,68.48,45.08
NCT OF DELHI,North West,3656539,1960922,1695617,2707855,1541952,1165903,1026867,1188545,1135126,53419,864.7039504885968,74.06,78.63,68.76
NCT OF DELHI,North,887978,475002,412976,681517,381615,299902,301071,296446,283583,12863,869.4194971810645,76.75,80.34,72.62
NCT OF DELHI,North East,2241624,1188425,1053199,1611588,912481,699107,487581,661386,622443,38943,886.2141069061994,71.89,76.78,66.38
NCT OF DELHI,East,1709346,907500,801846,1352998,748382,604616,462218,579692,555026,24666,883.5768595041322,79.15,82.47,75.4
NCT OF DELHI,New Delhi,142004,77942,64062,114179,65678,48501,52664,59541,56471,3070,821.9188627440917,80.41,84.27,75.71
NCT OF DELHI,Central,582320,307821,274499,442360,240518,201842,194897,207374,195978,11396,891.7487760744068,75.97,78.14,73.53
NCT OF DELHI,West,2543243,1356240,1187003,1961179,1093933,867246,701512,874320,839621,34699,875.2160384592697,77.11,80.66,73.06
NCT OF DELHI,South West,2292958,1246046,1046912,1787689,1025261,762428,647682,795352,749995,45357,840.1872804053783,77.96,82.28,72.83
NCT OF DELHI,South,2731929,1467428,1264501,2078402,1185036,893366,731063,924393,869086,55307,861.712465620119,76.08,80.76,70.65
RAJASTHAN,Ganganagar,1969168,1043340,925828,1193343,710908,482435,562594,912672,680563,232109,887.3694097801292,60.6,68.14,52.11
RAJASTHAN,Hanumangarh,1774692,931184,843508,1034136,624281,409855,497753,835260,642109,193151,905.8446021409302,58.27,67.04,48.59
RAJASTHAN,Bikaner,2363937,1240801,1123136,1278801,782399,496402,531933,986208,752768,233440,905.170128006022,54.1,63.06,44.2
RAJASTHAN,Churu,2039547,1051446,988101,1149269,696729,452540,493893,902829,628381,274448,939.7543953755114,56.35,66.26,45.8
RAJASTHAN,Jhunjhunun,2137045,1095896,1041149,1370360,815834,554526,650809,894649,592813,301836,950.0436172775519,64.12,74.44,53.26
RAJASTHAN,Alwar,3674179,1939026,1735153,2182476,1359829,822647,995261,1708542,1179461,529081,894.8580369732019,59.4,70.13,47.41
RAJASTHAN,Bharatpur,2548462,1355726,1192736,1480869,943910,536959,609134,1071154,694929,376225,879.7765920252323,58.11,69.62,45.02
RAJASTHAN,Dhaulpur,1206516,653647,552869,683098,435721,247377,273296,523212,317617,205595,845.821980365549,56.62,66.66,44.74
RAJASTHAN,Karauli,1458248,783639,674609,805849,531904,273945,364355,628726,438337,190389,860.8670574078116,55.26,67.88,40.61
RAJASTHAN,Sawai Madhopur,1335551,704031,631520,741748,486184,255564,353321,578068,418555,159513,897.005955703655,55.54,69.06,40.47
RAJASTHAN,Dausa,1634409,857787,776622,938051,596935,341116,420694,684495,506214,178281,905.378607976106,57.39,69.59,43.92
RAJASTHAN,Jaipur,6626178,3468507,3157671,4300965,2554793,1746172,1732679,2464893,2060010,404883,910.3833436115308,64.91,73.66,55.3
RAJASTHAN,Sikar,2677333,1374990,1302343,1652117,995275,656842,705834,1006504,698711,307793,947.1654339304287,61.71,72.38,50.44
RAJASTHAN,Nagaur,3307743,1696325,1611418,1758624,1102750,655874,842201,1425882,985927,439955,949.9465019969641,53.17,65.01,40.7
RAJASTHAN,Jodhpur,3687165,1923928,1763237,2031532,1265753,765779,891657,1489741,1056479,433262,916.4776436540245,55.1,65.79,43.43
RAJASTHAN,Jaisalmer,669919,361708,308211,308653,210415,98238,189947,288903,175383,113520,852.0989306291262,46.07,58.17,31.87
RAJASTHAN,Barmer,2603751,1369022,1234729,1188322,783461,404861,598805,1202482,741367,461115,901.905886099712,45.64,57.23,32.79
RAJASTHAN,Jalor,1828730,936634,892096,829582,543923,285659,467418,896644,660719,235925,952.4488754412076,45.36,58.07,32.02
RAJASTHAN,Sirohi,1036346,534231,502115,476806,309900,166906,308174,419829,313292,106537,939.8836832755868,46.01,58.01,33.24
RAJASTHAN,Pali,2037573,1025422,1012151,1085693,667381,418312,652717,842327,605288,237039,987.0580112383,53.28,65.08,41.33
RAJASTHAN,Ajmer,2583052,1324085,1258967,1526673,926268,600405,684254,1053722,827181,226541,950.8203778458331,59.1,69.96,47.69
RAJASTHAN,Tonk,1421326,728136,693190,749659,478329,271330,380666,649161,495797,153364,952.0062186184999,52.74,65.69,39.14
RAJASTHAN,Bundi,1110906,577160,533746,585044,371705,213339,303288,526091,361070,165021,924.7799570309793,52.66,64.4,39.97
RAJASTHAN,Bhilwara,2408523,1220736,1187787,1256126,777582,478544,675880,1148165,883329,264836,973.0089061025479,52.15,63.7,40.29
RAJASTHAN,Rajsamand,1156597,581339,575258,619139,383334,235805,365676,550831,362584,188247,989.5396661844466,53.53,65.94,40.99
RAJASTHAN,Dungarpur,1388552,696532,692020,681591,415820,265771,354363,641515,216411,425104,993.5221928066478,49.09,59.7,38.41
RAJASTHAN,Banswara,1797485,907754,889731,829343,513854,315489,429844,916574,542983,373591,980.1455019752048,46.14,56.61,35.46
RAJASTHAN,Chittaurgarh,1544338,783171,761167,821825,514851,306974,455653,802755,656904,145851,971.903964779084,53.22,65.74,40.33
RAJASTHAN,Kota,1951014,1021161,929853,1298345,765396,532949,515189,748811,577548,171263,910.5841292411285,66.55,74.95,57.32
RAJASTHAN,Baran,1222755,633945,588810,693307,432607,260700,318988,552583,359785,192798,928.8029718666446,56.7,68.24,44.28
RAJASTHAN,Jhalawar,1411129,725143,685986,739792,466815,272977,362387,685950,475653,210297,946.0009956656825,52.43,64.38,39.79
RAJASTHAN,Udaipur,3068420,1566801,1501619,1582629,973444,609185,848218,1365783,822355,543428,958.3980352322982,51.58,62.13,40.57
RAJASTHAN,Pratapgarh,867848,437744,430104,401515,250122,151393,234082,481294,327445,153849,982.5468767133302,46.27,57.14,35.2
UTTAR PRADESH,Saharanpur,3466382,1834106,1632276,2077108,1220114,856994,889238,1037344,882701,154643,889.9572870924582,59.92,66.52,52.5
UTTAR PRADESH,Muzaffarnagar,4143512,2193434,1950078,2417339,1448528,968811,969850,1291644,1085491,206153,889.0525085322831,58.34,66.04,49.68
UTTAR PRADESH,Bijnor,3682713,1921215,1761498,2135393,1241471,893922,908523,1088036,839778,248258,916.8666703101943,57.98,64.62,50.75
UTTAR PRADESH,Moradabad,4772006,2503186,2268820,2263848,1357435,906413,1047916,1417811,1104968,312843,906.3729183528511,47.44,54.23,39.95
UTTAR PRADESH,Rampur,2335819,1223889,1111930,1043666,630408,413258,539992,737261,564266,172995,908.5219329530701,44.68,51.51,37.17
UTTAR PRADESH,Jyotiba Phule Nagar,1840221,963449,876772,983110,600541,382569,451374,599089,453567,145522,910.0346774972002,53.42,62.33,43.63
UTTAR PRADESH,Meerut,3443689,1825743,1617946,2141488,1254520,886968,803823,1090539,890810,199729,886.1849668874535,62.19,68.71,54.82
UTTAR PRADESH,Baghpat,1303048,700070,602978,797970,489858,308112,316046,416695,334519,82176,861.3110117559672,61.24,69.97,51.1
UTTAR PRADESH,Ghaziabad,4681645,2488834,2192811,3123264,1811397,1311867,1191723,1520538,1252911,267627,881.0595644386085,66.71,72.78,59.83
UTTAR PRADESH,Gautam Buddha Nagar,1648115,890214,757901,1122947,666065,456882,509770,569109,458492,110617,851.369445998378,68.14,74.82,60.28
UTTAR PRADESH,Bulandshahr,3499171,1845260,1653911,2031656,1253314,778342,880077,1173260,885216,288044,896.3024180874239,58.06,67.92,47.06
UTTAR PRADESH,Aligarh,3673889,1951996,1721893,2092567,1283380,809187,858059,1174361,865799,308562,882.1191231949246,56.96,65.75,46.99
UTTAR PRADESH,Mahamaya Nagar,1564708,836127,728581,942572,579157,363415,373033,484115,337295,146820,871.3759991006151,60.24,69.27,49.88
UTTAR PRADESH,Mathura,2547184,1367125,1180059,1507746,943346,564400,585290,840939,594799,246140,863.1683276949803,59.19,69.0,47.83
UTTAR PRADESH,Agra,4418797,2364953,2053844,2680510,1614594,1065916,903823,1389844,1050562,339282,868.4502398144909,60.66,68.27,51.9
UTTAR PRADESH,Firozabad,2498156,1332046,1166110,1521806,912314,609492,535368,761521,573649,187872,875.4277254689403,60.92,68.49,52.27
UTTAR PRADESH,Mainpuri,1868529,993377,875152,1203885,712110,491775,411258,560840,424782,136058,880.986775413564,64.43,71.69,56.19
UTTAR PRADESH,Budaun,3681896,1967759,1714137,1547477,986501,560976,867624,1107343,875763,231580,871.111248887694,42.03,50.13,32.73
UTTAR PRADESH,Bareilly,4448359,2357665,2090694,2191759,1342697,849062,994411,1401971,1043912,358059,886.7646591012718,49.27,56.95,40.61
UTTAR PRADESH,Pilibhit,2031007,1072002,959005,1061095,654290,406805,461390,618605,463415,155190,894.5925474019638,52.24,61.03,42.42
UTTAR PRADESH,Shahjahanpur,3006538,1606403,1400135,1490930,915142,575788,655003,892214,699503,192711,871.5963553354917,49.59,56.97,41.12
UTTAR PRADESH,Kheri,4021243,2123187,1898056,2034044,1237157,796887,862610,1264718,958249,306469,893.9655338884422,50.58,58.27,41.98
UTTAR PRADESH,Sitapur,4483992,2375264,2108728,2283733,1397702,886031,938902,1422602,1023642,398960,887.7867891737508,50.93,58.84,42.02
UTTAR PRADESH,Hardoi,4092845,2191442,1901403,2221601,1374587,847014,907677,1318946,969871,349075,867.6492464778898,54.28,62.73,44.55
UTTAR PRADESH,Unnao,3108367,1630087,1478280,1773584,1053063,720521,717356,1124744,761831,362913,906.8718418096703,57.06,64.6,48.74
UTTAR PRADESH,Lucknow,4589838,2394476,2195362,3127260,1742440,1384820,1061721,1542806,1152285,390521,916.8444369457034,68.13,72.77,63.08
UTTAR PRADESH,Rae Bareli,3405559,1752542,1653017,1965843,1165965,799878,778418,1204710,644869,559841,943.2110614182142,57.72,66.53,48.39
UTTAR PRADESH,Farrukhabad,1885204,1006240,878964,1092677,654827,437850,411490,592267,474686,117581,873.5132771505804,57.96,65.08,49.81
UTTAR PRADESH,Kannauj,1656616,881776,774840,1017087,603596,413491,365770,524676,419027,105649,878.7265700132459,61.4,68.45,53.36
UTTAR PRADESH,Etawah,1581810,845856,735954,1062003,623583,438420,351126,506072,361588,144484,870.0700828509817,67.14,73.72,59.57
UTTAR PRADESH,Auraiya,1379545,740040,639505,930836,546198,384638,314274,442023,325721,116302,864.1492351764769,67.47,73.81,60.15
UTTAR PRADESH,Kanpur Dehat,1796184,963255,832929,1170243,692964,477279,405256,628864,448651,180213,864.7024931093013,65.15,71.94,57.3
UTTAR PRADESH,Kanpur Nagar,4581268,2459806,2121462,3243022,1829179,1413843,1049775,1572232,1229166,343066,862.4509412530907,70.79,74.36,66.64
UTTAR PRADESH,Jalaun,1689974,906092,783882,1075196,653430,421766,396421,620764,420266,200498,865.1240712863595,63.62,72.12,53.8
UTTAR PRADESH,Jhansi,1998603,1057436,941167,1304513,783705,520808,504913,814914,560041,254873,890.0463006744617,65.27,74.11,55.34
UTTAR PRADESH,Lalitpur,1221592,641011,580581,641191,397586,243605,301832,503351,357033,146318,905.727046805749,52.49,62.02,41.96
UTTAR PRADESH,Hamirpur,1104285,593537,510748,653299,408125,245174,311381,443655,290375,153280,860.5158566357278,59.16,68.76,48.0
UTTAR PRADESH,Mahoba,875958,466358,409600,488106,302283,185823,246823,349676,238712,110964,878.2952152638102,55.72,64.82,45.37
UTTAR PRADESH,Banda,1799410,965876,833534,1002937,630626,372311,445625,701689,483232,218457,862.9824118209791,55.74,65.29,44.67
UTTAR PRADESH,Chitrakoot,991730,527721,464009,531072,330339,200733,230795,394197,282614,111583,879.2695382598001,53.55,62.6,43.26
UTTAR PRADESH,Fatehpur,2632733,1384722,1248011,1512166,911003,601163,636540,1063929,670156,393773,901.2718798430299,57.44,65.79,48.17
UTTAR PRADESH,Pratapgarh,3209141,1606085,1603056,1931559,1121381,810178,752786,1066601,553013,513588,998.1140475130519,60.19,69.82,50.54
UTTAR PRADESH,Kaushambi,1599596,838485,761111,813424,507279,306145,380620,639086,415312,223774,907.7216646690161,50.85,60.5,40.22
UTTAR PRADESH,Allahabad,5954391,3131807,2822584,3665727,2199340,1466387,1248570,2111907,1286732,825175,901.2637113334251,61.56,70.23,51.95
UTTAR PRADESH,Bara Banki,3260699,1707073,1553626,1692458,1010518,681940,714908,1192850,834294,358556,910.1110497324953,51.9,59.2,43.89
UTTAR PRADESH,Faizabad,2470996,1259628,1211368,1450901,838339,612562,589666,831209,496579,334630,961.687101271169,58.72,66.55,50.57
UTTAR PRADESH,Ambedkar Nagar,2397888,1212410,1185478,1486939,846676,640263,566590,787398,440998,346400,977.7863923920125,62.01,69.83,54.01
UTTAR PRADESH,Sultanpur,3797117,1914586,1882531,2239902,1300248,939654,889628,1242632,690967,551665,983.2574770733726,58.99,67.91,49.91
UTTAR PRADESH,Bahraich,3487731,1843884,1643847,1398368,878285,520083,760262,1152160,743452,408708,891.5132405292306,40.09,47.63,31.64
UTTAR PRADESH,Shrawasti,1117361,593897,523464,423313,276700,146613,257274,403755,232762,170993,881.4053615357545,37.89,46.59,28.01
UTTAR PRADESH,Balrampur,2148665,1114721,1033944,868357,544943,323414,445838,760253,458727,301526,927.5361278741497,40.41,48.89,31.28
UTTAR PRADESH,Gonda,3433919,1787146,1646773,1679994,1034181,645813,726372,1170552,739663,430889,921.454094964821,48.92,57.87,39.22
UTTAR PRADESH,Siddharthnagar,2559297,1295095,1264202,1228926,740718,488208,513513,878898,447943,430955,976.1461514406279,48.02,57.19,38.62
UTTAR PRADESH,Basti,2464464,1255272,1209192,1393783,819719,574064,545025,783688,443724,339964,963.2908246180908,56.56,65.3,47.48
UTTAR PRADESH,Sant Kabir Nagar,1715183,869656,845527,954949,567098,387851,352151,539469,265453,274016,972.2545466253323,55.68,65.21,45.87
UTTAR PRADESH,Mahrajganj,2684703,1381754,1302949,1419144,881674,537470,607079,994253,439293,554960,942.9674167760686,52.86,63.81,41.25
UTTAR PRADESH,Gorakhpur,4440895,2277777,2163118,2700328,1593890,1106438,951128,1351629,746381,605248,949.6618852503999,60.81,69.98,51.15
UTTAR PRADESH,Kushinagar,3564544,1818055,1746489,1954820,1183722,771098,785099,1116973,523258,593715,960.6359543578164,54.84,65.11,44.15
UTTAR PRADESH,Deoria,3100946,1537436,1563510,1875239,1079288,795951,665706,876246,455382,420864,1016.959405139466,60.47,70.2,50.91
UTTAR PRADESH,Azamgarh,4613913,2285004,2328909,2771917,1559414,1212503,971458,1372032,784272,587760,1019.2144083774033,60.08,68.25,52.06
UTTAR PRADESH,Mau,2205968,1114709,1091259,1363044,773082,589962,451528,696747,396438,300309,978.9631195226737,61.79,69.35,54.06
UTTAR PRADESH,Ballia,3239774,1672902,1566872,1963590,1160960,802630,629381,1019483,569522,449961,936.6191205462126,60.61,69.4,51.22
UTTAR PRADESH,Jaunpur,4494204,2220465,2273739,2731677,1565394,1166283,1006670,1437375,896547,540828,1023.9922718889962,60.78,70.5,51.29
UTTAR PRADESH,Ghazipur,3620268,1855075,1765193,2197549,1293553,903996,761640,1204602,766881,437721,951.5480506178995,60.7,69.73,51.21
UTTAR PRADESH,Chandauli,1952756,1017905,934851,1174606,699454,475152,395759,652543,341927,310616,918.4069240253266,60.15,68.72,50.83
UTTAR PRADESH,Varanasi,3676841,1921857,1754984,2403903,1389116,1014787,755064,1220708,920761,299947,913.1709591296334,65.38,72.28,57.82
UTTAR PRADESH,Sant Ravidas Nagar (Bhadohi),1578213,807099,771114,910146,546782,363364,339507,470608,286978,183630,955.4143915430449,57.67,67.75,47.12
UTTAR PRADESH,Mirzapur,2496970,1312302,1184668,1428683,865837,562846,543115,881996,537091,344905,902.7403753099516,57.22,65.98,47.51
UTTAR PRADESH,Sonbhadra,1862559,971344,891215,985708,601988,383720,428088,730399,397196,333203,917.5070829695761,52.92,61.97,43.06
UTTAR PRADESH,Etah,1774480,947339,827141,1055202,647042,408160,401998,545984,415476,130508,873.1203930166498,59.47,68.3,49.35
UTTAR PRADESH,Kanshiram Nagar,1436719,764165,672554,724850,452803,272047,343724,472765,354257,118508,880.1162052698043,50.45,59.25,40.45
BIHAR,Pashchim Champaran,3935042,2061110,1873932,1759481,1091226,668255,936134,1478947,797544,681403,909.1858270543543,44.71,52.94,35.66
BIHAR,Purba Champaran,5099371,2681209,2418162,2276957,1407603,869354,1243825,1737539,1132789,604750,901.8923925736487,44.65,52.5,35.95
BIHAR,Sheohar,656246,346673,309573,283698,171645,112053,166000,216372,137804,78568,892.9827243540743,43.23,49.51,36.2
BIHAR,Sitamarhi,3423574,1803252,1620322,1436794,885188,551606,856964,1114583,753645,360938,898.5554986213796,41.97,49.09,34.04
BIHAR,Madhubani,4487379,2329313,2158066,2155338,1340085,815253,1088786,1636938,1074091,562847,926.481756638116,48.03,57.53,37.78
BIHAR,Supaul,2229076,1155283,1073793,1033283,647672,385611,600102,877682,472649,405033,929.4631704958871,46.35,56.06,35.91
BIHAR,Araria,2811569,1463333,1348236,1195768,727643,468125,703274,1069893,696410,373483,921.3459957507963,42.53,49.73,34.72
BIHAR,Kishanganj,1690400,866970,823430,745056,439921,305135,445150,529064,384416,144648,949.7791157710186,44.08,50.74,37.06
BIHAR,Purnia,3264619,1699370,1565249,1332326,805261,527065,798596,1143318,776385,366933,921.0760458287482,40.81,47.39,33.67
BIHAR,Katihar,3071029,1600430,1470599,1280190,762256,517934,738070,1013566,667602,345964,918.8774266915767,41.69,47.63,35.22
BIHAR,Madhepura,2001762,1047559,954203,834577,517666,316911,510278,777546,443507,334039,910.8823464835871,41.69,49.42,33.21
BIHAR,Saharsa,1900661,997174,903487,804996,506374,298622,470697,649898,363326,286572,906.0474902073258,42.35,50.78,33.05
BIHAR,Darbhanga,3937385,2059949,1877436,1816634,1125566,691068,1002713,1223640,731347,492293,911.3992627972829,46.14,54.64,36.81
BIHAR,Muzaffarpur,4801062,2527497,2273565,2509232,1487117,1022115,1119394,1547586,910304,637282,899.5322249640652,52.26,58.84,44.96
BIHAR,Gopalganj,2562012,1267666,1294346,1382998,793905,589093,554058,728201,363111,365090,1021.0465532719186,53.98,62.63,45.51
BIHAR,Siwan,3330464,1675090,1655374,1930175,1115906,814269,674372,932416,462104,470312,988.2298861553708,57.96,66.62,49.19
BIHAR,Saran,3951862,2022821,1929041,2157454,1285767,871687,777622,1040231,545520,494711,953.6390021657872,54.59,63.56,45.19
BIHAR,Vaishali,3495021,1844535,1650486,1926740,1152576,774164,750811,1060344,716006,344338,894.7978758874187,55.13,62.49,46.91
BIHAR,Samastipur,4261566,2230003,2031563,2142880,1293575,849305,1056465,1343400,907433,435967,911.0135726274807,50.28,58.01,41.81
BIHAR,Begusarai,2970541,1567660,1402881,1548673,918507,630166,733625,938182,591811,346371,894.888560019392,52.13,58.59,44.92
BIHAR,Khagaria,1666886,883786,783100,768028,461153,306875,394703,560805,306283,254522,886.0742306395439,46.08,52.18,39.19
BIHAR,Bhagalpur,3037766,1615663,1422103,1573066,937669,635397,653161,983528,534129,449399,880.1977887715445,51.78,58.04,44.68
BIHAR,Banka,2034763,1067140,967623,965321,590961,374360,444096,771080,374097,396983,906.7441947635737,47.44,55.38,38.69
BIHAR,Munger,1367765,729041,638724,801817,473741,328076,308063,426658,233402,193256,876.1153350771767,58.62,64.98,51.36
BIHAR,Lakhisarai,1000912,526345,474567,507270,305182,202088,207645,326576,201866,124710,901.6272596870873,50.68,57.98,42.58
BIHAR,Sheikhpura,636342,329743,306599,328676,196431,132245,132638,224655,148002,76653,929.8120051070076,51.65,59.57,43.13
BIHAR,Nalanda,2877653,1497060,1380593,1519933,919558,600375,616663,1045420,740949,304471,922.2028509211387,52.82,61.42,43.49
BIHAR,Patna,5838465,3078512,2759953,3459679,2028047,1431632,1210094,1881886,1371267,510619,896.5217611625357,59.26,65.88,51.87
BIHAR,Bhojpur,2728407,1430380,1298027,1599151,973486,625665,511927,822493,512009,310484,907.4700429256561,58.61,68.06,48.2
BIHAR,Buxar,1706352,887977,818375,989807,593544,396263,334657,538322,328547,209775,921.6173391878393,58.01,66.84,48.42
BIHAR,Kaimur (Bhabua),1626384,847006,779378,920276,549923,370353,340442,511163,284646,226517,920.156409753886,56.58,64.93,47.52
BIHAR,Rohtas,2959918,1543546,1416372,1799832,1061783,738049,608061,924879,542439,382440,917.609193376809,60.81,68.79,52.11
BIHAR,Aurangabad,2540073,1318684,1221389,1466002,868733,597269,477297,837770,480286,357484,926.218108356513,57.71,65.88,48.9
BIHAR,Gaya,4391418,2266566,2124852,2297613,1368803,928810,807571,1664062,1007057,657005,937.4763408610206,52.32,60.39,43.71
BIHAR,Nawada,2219146,1144668,1074478,1091012,659474,431538,424874,817041,508509,308532,938.6809100979499,49.16,57.61,40.16
BIHAR,Jamui,1760405,916064,844341,858588,534385,324203,356760,727571,445352,282219,921.7052520347924,48.77,58.33,38.4
BIHAR,Jehanabad,1125313,585582,539731,618881,374412,244469,214792,365378,251690,113688,921.7001205638151,55.0,63.94,45.29
BIHAR,Arwal,700843,363497,337346,386351,235279,151072,144294,236354,161277,75077,928.0571779134353,55.13,64.73,44.78
SIKKIM,North  District,43709,24730,18979,30450,18579,11871,13609,23359,17216,6143,767.4484431864132,69.67,75.13,62.55
SIKKIM,West District,136435,70238,66197,93432,51988,41444,33977,70348,51225,19123,942.4670406332755,68.48,74.02,62.61
SIKKIM,South District,146850,76670,70180,106741,59357,47384,39298,74753,50898,23855,915.351506456241,72.69,77.42,67.52
SIKKIM,East District,283583,151432,132151,214329,121345,92984,82138,139678,111058,28620,872.6755243277511,75.58,80.13,70.36
ARUNACHAL PRADESH,Tawang,49977,29151,20826,26073,17720,8353,13182,28561,24430,4131,714.418030256252,52.17,60.79,40.11
ARUNACHAL PRADESH,West Kameng,83947,46155,37792,48492,29566,18926,24195,42493,34752,7741,818.8061965117539,57.77,64.06,50.08
ARUNACHAL PRADESH,East Kameng,78690,38775,39915,38449,21599,16850,19718,31710,27123,4587,1029.4003868471953,48.86,55.7,42.21
ARUNACHAL PRADESH,Papum Pare,176573,89182,87391,121048,65794,55254,50488,65772,51157,14615,979.9174721356327,68.55,73.77,63.23
ARUNACHAL PRADESH,Upper Subansiri,83448,41758,41690,45278,24807,20471,19214,33370,25717,7653,998.371569519613,54.26,59.41,49.1
ARUNACHAL PRADESH,West Siang,112274,58168,54106,64746,36777,27969,30775,49177,43000,6177,930.1677898500894,57.67,63.23,51.69
ARUNACHAL PRADESH,East Siang,99214,50116,49098,62576,34210,28366,29021,40222,33578,6644,979.6871258679862,63.07,68.26,57.77
ARUNACHAL PRADESH,Upper Siang,35320,18699,16621,18195,10723,7472,10751,17644,14524,3120,888.8710626236697,51.51,57.35,44.96
ARUNACHAL PRADESH,Changlang,148226,76948,71278,73174,44027,29147,39920,62966,50765,12201,926.3138743047252,49.37,57.22,40.89
ARUNACHAL PRADESH,Tirap,111975,57604,54371,47974,29313,18661,24920,50169,44262,5907,943.8754253176863,42.84,50.89,34.32
ARUNACHAL PRADESH,Lower Subansiri,83030,41843,41187,54057,29470,24587,23477,30202,22669,7533,984.3223478240088,65.11,70.43,59.7
ARUNACHAL PRADESH,Kurung Kumey,92076,45318,46758,36606,20258,16348,19695,38044,24372,13672,1031.7754534622004,39.76,44.7,34.96
ARUNACHAL PRADESH,Dibang Valley,8004,4414,3590,4436,2614,1822,3230,3555,2525,1030,813.3212505663797,55.42,59.22,50.75
ARUNACHAL PRADESH,Lower Dibang Valley,54080,28053,26027,31849,18087,13762,15950,22326,19829,2497,927.7795601183474,58.89,64.47,52.88
ARUNACHAL PRADESH,Lohit,145726,76221,69505,83062,48380,34682,44971,60945,50754,10191,911.887799950145,57.0,63.47,49.9
ARUNACHAL PRADESH,Anjaw,21167,11507,9660,9990,6523,3467,6453,10501,9264,1237,839.489006691579,47.2,56.69,35.89
NAGALAND,Mon,250260,131753,118507,119626,67432,52194,51022,147654,104981,42673,899.4633898279357,47.8,51.18,44.04
NAGALAND,Mokokchung,194622,101092,93530,159494,83479,76015,55278,100067,81046,19021,925.1968503937009,81.95,82.58,81.27
NAGALAND,Zunheboto,140757,71217,69540,102881,53504,49377,37311,79466,49382,30084,976.4522515691478,73.09,75.13,71.01
NAGALAND,Wokha,166343,84505,81838,128208,67385,60823,46669,78412,63512,14900,968.4397372936513,77.07,79.74,74.32
NAGALAND,Dimapur,378811,197394,181417,278037,150142,127895,111969,151350,122358,28992,919.0603564444715,73.4,76.06,70.5
NAGALAND,Phek,163418,83743,79675,105893,57926,47967,46198,80277,63645,16632,951.4228054882199,64.8,69.17,60.2
NAGALAND,Tuensang,196596,101933,94663,117511,63653,53858,50141,98154,73518,24636,928.6786418529819,59.77,62.45,56.89
NAGALAND,Longleng,50484,26502,23982,29859,16139,13720,15137,30568,20944,9624,904.9128367670365,59.15,60.9,57.21
NAGALAND,Kiphire,74004,37830,36174,41232,22675,18557,20322,31959,25830,6129,956.2252180808882,55.72,59.94,51.3
NAGALAND,Kohima,267988,138966,129022,197489,107038,90451,76100,114825,99408,15417,928.4429284861045,73.69,77.02,70.11
NAGALAND,Peren,95219,49714,45505,62204,34584,27620,24277,61390,36555,24835,915.3357203202316,65.33,69.57,60.7
MANIPUR,Senapati,479148,247323,231825,264477,148012,116465,39834,233622,185725,47897,937.3370046457467,55.2,59.85,50.24
MANIPUR,Tamenglong,140651,72371,68280,85006,47403,37603,28101,70675,55979,14696,943.4718326401459,60.44,65.5,55.07
MANIPUR,Churachandpur,274143,138820,135323,195935,104013,91922,57825,122655,89779,32876,974.8091053162369,71.47,74.93,67.93
MANIPUR,Bishnupur,237399,118782,118617,156333,87313,69020,56149,109937,76423,33514,998.6109006415114,65.85,73.51,58.19
MANIPUR,Thoubal,422168,210845,211323,269304,152617,116687,104263,195319,133428,61891,1002.2670682254737,63.79,72.38,55.22
MANIPUR,Imphal West,517992,255054,262938,392626,205985,186641,136801,213387,166009,47378,1030.911101178574,75.8,80.76,70.98
MANIPUR,Imphal East,456113,226094,230019,324664,173314,151350,110941,194848,145343,49505,1017.3600360911835,71.18,76.66,65.8
MANIPUR,Ukhrul,183998,94718,89280,129829,70148,59681,41890,87929,67724,20205,942.5874701746236,70.56,74.06,66.85
MANIPUR,Chandel,144182,74579,69603,90302,51053,39249,34160,76238,53753,22485,933.2788050255434,62.63,68.45,56.39
MIZORAM,Mamit,86364,44828,41536,60191,32977,27214,20855,39339,36185,3154,926.5637547961095,69.69,73.56,65.52
MIZORAM,Kolasib,83955,42918,41037,65895,34147,31748,22176,36672,29697,6975,956.1722354256955,78.49,79.56,77.36
MIZORAM,Aizawl,400309,199270,201039,340595,169547,171048,100911,174636,151410,23226,1008.8774025191951,85.08,85.08,85.08
MIZORAM,Champhai,125745,63388,62357,100802,51440,49362,31112,60342,53111,7231,983.7350918154856,80.16,81.15,79.16
MIZORAM,Serchhip,64937,32851,32086,54476,27598,26878,15490,32397,29838,2559,976.713037654866,83.89,84.01,83.77
MIZORAM,Lunglei,161428,82891,78537,121122,64515,56607,38794,78292,62013,16279,947.4731876802065,75.03,77.83,72.08
MIZORAM,Lawngtlai,117894,60599,57295,62861,36444,26417,27266,45566,38082,7484,945.477648146009,53.32,60.14,46.11
MIZORAM,Saiha,56574,28594,27980,42233,21861,20372,12827,19461,14694,4767,978.5269636986781,74.65,76.45,72.81
TRIPURA,West Tripura,1725739,879428,846311,1361354,722998,638356,506637,698178,524198,173980,962.3425681238259,78.89,82.21,75.43
TRIPURA,South Tripura,876001,447544,428457,646810,351082,295728,264077,366845,258457,108388,957.3516793879484,73.84,78.45,69.02
TRIPURA,Dhalai,378230,194544,183686,276217,151643,124574,103528,155831,108259,47572,944.1874331770705,73.03,77.95,67.82
TRIPURA,North Tripura,693947,352860,341087,520402,275646,244756,192621,248667,186105,62562,966.6354928300176,74.99,78.12,71.76
MEGHALAYA,West Garo Hills,643291,324159,319132,358702,193438,165264,157945,255693,188371,67322,984.4921782211816,55.76,59.67,51.79
MEGHALAYA,East Garo Hills,317917,161223,156694,192147,102513,89634,74216,126073,83936,42137,971.9084745972968,60.44,63.58,57.2
MEGHALAYA,South Garo Hills,142334,73170,69164,82062,45003,37059,39643,53069,38397,14672,945.2507858411917,57.65,61.5,53.58
MEGHALAYA,West Khasi Hills,383461,193715,189746,230678,117307,113371,87131,163345,119803,43542,979.5111374958057,60.16,60.56,59.75
MEGHALAYA,Ribhoi,258840,132531,126309,155859,80977,74882,63724,106473,90875,15598,953.0524933789077,60.21,61.1,59.28
MEGHALAYA,East Khasi Hills,825922,410749,415173,578030,287270,290760,215091,326786,289576,37210,1010.770567913738,69.99,69.94,70.03
MEGHALAYA,Jaintia Hills,395124,196285,198839,187527,87371,100156,83717,154180,110617,43563,1013.0116921822861,47.46,44.51,50.37
ASSAM,Kokrajhar,887142,452905,434237,489305,275220,214085,222011,341131,253110,88021,958.7816429494044,55.16,60.77,49.3
ASSAM,Dhubri,1949258,997848,951410,922341,511551,410790,521019,669819,504998,164821,953.461849900987,47.32,51.27,43.18
ASSAM,Goalpara,1008183,513292,494891,563577,304302,259275,268114,362573,266376,96197,964.1510095618089,55.9,59.28,52.39
ASSAM,Barpeta,1693622,867004,826618,897058,499038,398020,499381,561824,439453,122371,953.4189000281428,52.97,57.56,48.15
ASSAM,Morigaon,957423,486651,470772,539902,289698,250204,257481,351148,260968,90180,967.3708674183347,56.39,59.53,53.15
ASSAM,Nagaon,2823768,1439112,1384656,1710716,921850,788866,799185,979998,734993,245005,962.1599986658439,60.58,64.06,56.97
ASSAM,Sonitpur,1924110,983904,940206,1108572,620525,488047,547853,770606,558325,212281,955.5871304517514,57.61,63.07,51.91
ASSAM,Lakhimpur,1042137,529674,512463,683486,375552,307934,327933,429995,283533,146462,967.5064284824251,65.59,70.9,60.09
ASSAM,Dhemaji,686133,351249,334884,423028,237761,185267,228262,316800,201364,115436,953.4091200259644,61.65,67.69,55.32
ASSAM,Tinsukia,1327929,680231,647698,798322,453449,344873,381614,557196,410188,147008,952.173599850639,60.12,66.66,53.25
ASSAM,Dibrugarh,1326335,676434,649901,884531,491361,393170,377015,560557,391597,168960,960.7751827968435,66.69,72.64,60.5
ASSAM,Sivasagar,1151050,589216,561834,813505,444767,368738,405229,485717,318950,166767,953.5280779883778,70.68,75.48,65.63
ASSAM,Jorhat,1092256,556805,535451,794929,432335,362594,367154,498618,338635,159983,961.6490512836631,72.78,77.65,67.72
ASSAM,Golaghat,1066888,543161,523727,721764,396475,325289,327083,479928,331210,148718,964.220553390247,67.65,72.99,62.11
ASSAM,Karbi Anglong,956313,490167,466146,557214,314253,242961,252876,383441,260482,122959,950.9942529790867,58.27,64.11,52.12
ASSAM,Dima Hasao,214102,110802,103300,140873,78559,62314,58919,85028,68297,16731,932.2936409090089,65.8,70.9,60.32
ASSAM,Cachar,1736617,886284,850333,1174128,639946,534182,435160,608062,471259,136803,959.4362529392384,67.61,72.21,62.82
ASSAM,Karimganj,1228686,625864,602822,795297,435942,359355,294640,399171,293392,105779,963.1836948602253,64.73,69.65,59.61
ASSAM,Hailakandi,659296,337890,321406,407366,226836,180530,175417,214240,165193,49047,951.2148924206103,61.79,67.13,56.17
ASSAM,Bongaigaon,738804,375818,362986,434078,237114,196964,220393,255806,191671,64135,965.8558131861698,58.75,63.09,54.26
ASSAM,Chirang,482162,244860,237302,259902,145869,114033,140631,193894,139027,54867,969.1333823409295,53.9,59.57,48.05
ASSAM,Kamrup,1517542,778461,739081,995319,550219,445100,434445,628954,421244,207710,949.4130084872588,65.59,70.68,60.22
ASSAM,Kamrup Metropolitan,1253938,647585,606353,1001191,537227,463964,428192,490932,413154,77778,936.3295937984974,79.84,82.96,76.52
ASSAM,Nalbari,771639,396006,375633,531771,293184,238587,238944,267623,196773,70850,948.5538097907607,68.91,74.04,63.52
ASSAM,Baksa,950075,481330,468745,572837,322614,250223,295221,406756,278297,128459,973.8536970477635,60.29,67.03,53.38
ASSAM,Darrang,928500,475273,453227,487039,268666,218373,288706,324843,241456,83387,953.6140281480328,52.45,56.53,48.18
ASSAM,Udalguri,831668,421617,410051,469926,264326,205600,281625,345030,253178,91852,972.5675198106338,56.5,62.69,50.14
WEST BENGAL,Darjiling,1846823,937259,909564,1315585,717673,597912,518959,683726,532855,150871,970.4510706218879,71.24,76.57,65.74
WEST BENGAL,Jalpaiguri,3872846,1983064,1889782,2498780,1396622,1102158,1117804,1512910,1153765,359145,952.9606709617037,64.52,70.43,58.32
WEST BENGAL,Koch Bihar,2819086,1451542,1367544,1850504,1028733,821771,900738,1127977,886357,241620,942.1318845751622,65.64,70.87,60.09
WEST BENGAL,Uttar Dinajpur,3007134,1551066,1456068,1489667,853495,636172,778250,1075626,824342,251284,938.7530898104917,49.54,55.03,43.69
WEST BENGAL,Dakshin Dinajpur,1676276,857199,819077,1083685,596474,487211,461026,702987,526470,176517,955.5272462987008,64.65,69.58,59.48
WEST BENGAL,Maldah,3988845,2051541,1937304,2086432,1152019,934413,958996,1537847,1050995,486852,944.3164918468605,52.31,56.15,48.23
WEST BENGAL,Murshidabad,7103807,3627564,3476243,4055834,2177187,1878647,1851965,2589907,2022083,567824,958.2857807608632,57.09,60.02,54.04
WEST BENGAL,Birbhum,3502404,1790920,1711484,2158447,1201481,956966,965609,1331603,912844,418759,955.6451432783151,61.63,67.09,55.91
WEST BENGAL,Barddhaman,7717563,3966889,3750674,5247208,2918040,2329168,2227236,2911251,2166742,744509,945.4950718308478,67.99,73.56,62.1
WEST BENGAL,Nadia,5167600,2653768,2513832,3480555,1878866,1601689,1549771,1842607,1595880,246727,947.268939862113,67.35,70.8,63.72
WEST BENGAL,North Twenty Four Parganas,10009781,5119389,4890392,7608693,4056046,3552647,2859140,3571624,3055630,515994,955.2686853841346,76.01,79.23,72.65
WEST BENGAL,Hugli,5519145,2814653,2704492,4078388,2211777,1866611,1640038,2152870,1714645,438225,960.8616053204428,73.9,78.58,69.02
WEST BENGAL,Bankura,3596674,1838095,1758579,2232992,1299337,933655,991400,1466220,916393,549827,956.7399943963724,62.08,70.69,53.09
WEST BENGAL,Puruliya,2930115,1496996,1433119,1624905,1002058,622847,752652,1249642,613398,636244,957.3298793049547,55.46,66.94,43.46
WEST BENGAL,Haora,4850029,2500819,2349210,3605206,1942824,1662382,1352697,1819845,1496267,323578,939.3762603371135,74.33,77.69,70.76
WEST BENGAL,Kolkata,4496694,2356766,2139928,3588137,1926915,1661222,1308106,1795740,1576419,219321,907.9934113102446,79.8,81.76,77.63
WEST BENGAL,South Twenty Four Parganas,8161961,4173778,3988183,5531657,3043277,2488380,2180232,2964494,2003685,960809,955.5330925602656,67.77,72.91,62.39
WEST BENGAL,Paschim Medinipur,5913457,3007885,2905572,4078412,2266913,1811499,1565383,2509159,1510548,998611,965.9850692430064,68.97,75.37,62.35
WEST BENGAL,Purba Medinipur,5095875,2629834,2466041,3923194,2149073,1774121,1363713,1910320,1127312,783008,937.7173616281483,76.99,81.72,71.94
JHARKHAND,Garhwa,1322784,683575,639209,653476,405161,248315,292052,571431,175126,396305,935.097099806166,49.4,59.27,38.85
JHARKHAND,Chatra,1042886,533935,508951,510061,303902,206159,215502,397690,195502,202188,953.2077874647663,48.91,56.92,40.51
JHARKHAND,Kodarma,716259,367222,349037,390249,238780,151469,151485,257418,143324,114094,950.4795464324033,54.48,65.02,43.4
JHARKHAND,Giridih,2445474,1258098,1187376,1253475,783736,469739,499450,1036277,412912,623365,943.7865730650553,51.26,62.3,39.56
JHARKHAND,Deoghar,1492073,775022,717051,793538,489837,303701,321710,551467,297146,254321,925.2008330086113,53.18,63.2,42.35
JHARKHAND,Godda,1313551,677927,635624,604519,376212,228307,292030,552191,235735,316456,937.5994760497812,46.02,55.49,35.92
JHARKHAND,Sahibganj,1150567,589391,561176,483263,287303,195960,260993,490202,322572,167630,952.1285530318582,42.0,48.75,34.92
JHARKHAND,Pakur,900422,452661,447761,352881,206989,145892,217175,404584,252017,152567,989.1751222217068,39.19,45.73,32.58
JHARKHAND,Dhanbad,2684487,1405956,1278531,1722204,1014950,707254,664219,844504,546714,297790,909.3677184776764,64.15,72.19,55.32
JHARKHAND,Bokaro,2062330,1072807,989523,1273520,759088,514432,508764,685368,380304,305064,922.3681426388903,61.75,70.76,51.99
JHARKHAND,Lohardaga,461790,232629,229161,259707,149568,110139,111484,221332,103001,118331,985.0921424242034,56.24,64.29,48.06
JHARKHAND,Purbi Singhbhum,2293919,1176902,1117017,1507699,856526,651173,604663,837167,529578,307589,949.116409012815,65.73,72.78,58.3
JHARKHAND,Palamu,1939869,1006302,933567,1024563,621706,402857,407904,713175,283702,429473,927.720505375126,52.82,61.78,43.15
JHARKHAND,Latehar,726978,369666,357312,350682,209706,140976,160514,313379,117311,196068,966.5806430669847,48.24,56.73,39.45
JHARKHAND,Hazaribagh,1734495,890881,843614,1013249,596113,417136,381748,654636,327316,327320,946.9435311786872,58.42,66.91,49.45
JHARKHAND,Ramgarh,949443,494230,455213,596497,350031,246466,252625,312125,221112,91013,921.0549744046294,62.83,70.82,54.14
JHARKHAND,Dumka,1321442,668514,652928,672409,406275,266134,326978,624779,237479,387300,976.6856041907873,50.88,60.77,40.76
JHARKHAND,Jamtara,791042,404830,386212,426312,258260,168052,185668,326631,122434,204197,954.01032532174,53.89,63.79,43.51
JHARKHAND,Ranchi,2914253,1494937,1419316,1911433,1085244,826189,730982,1142867,756176,386691,949.4152596397039,65.59,72.59,58.21
JHARKHAND,Khunti,531885,266335,265550,284575,164741,119834,135719,259984,153087,106897,997.0525841515386,53.5,61.85,45.13
JHARKHAND,Gumla,1025213,514390,510823,559720,321795,237925,233074,487508,278931,208577,993.0655728144015,54.6,62.56,46.58
JHARKHAND,Simdega,599578,300309,299269,343483,191991,151492,155283,288645,155510,133135,996.5369003259975,57.29,63.93,50.62
JHARKHAND,Pashchimi Singhbhum,1502338,749385,752953,727561,439273,288288,400324,694863,343008,351855,1004.7612375481227,48.43,58.62,38.29
JHARKHAND,Saraikela-Kharsawan,1065056,544411,520645,612993,365332,247661,285687,430051,228598,201453,956.3454816306063,57.56,67.11,47.57
ORISSA,Bargarh,1481255,749161,732094,983783,557217,426566,458961,762092,474390,287702,977.218515112239,66.42,74.38,58.27
ORISSA,Jharsuguda,579505,296690,282815,405879,228092,177787,177186,247707,172069,75638,953.2340153021672,70.04,76.88,62.86
ORISSA,Sambalpur,1041099,526877,514222,703691,393192,310499,315495,505840,336854,168986,975.9811113409771,67.59,74.63,60.38
ORISSA,Debagarh,312520,158230,154290,197819,112649,85170,98758,165435,83408,82027,975.0995386462744,63.3,71.19,55.2
ORISSA,Sundargarh,2093437,1061147,1032290,1342322,750147,592175,618062,873227,535112,338115,972.8058412265219,64.12,70.69,57.37
ORISSA,Kendujhar,1801733,906487,895246,1052518,605119,447399,574298,766514,442497,324017,987.5993809067312,58.42,66.75,49.97
ORISSA,Mayurbhanj,2519738,1256213,1263525,1369397,794171,575226,753589,1223534,548390,675144,1005.8206689470654,54.35,63.22,45.53
ORISSA,Baleshwar,2320529,1185787,1134742,1621232,902359,718873,683594,932707,618064,314643,956.9526398923247,69.86,76.1,63.35
ORISSA,Bhadrak,1506337,760260,746077,1094140,596269,497871,428106,468599,328097,140502,981.3445400257806,72.64,78.43,66.73
ORISSA,Kendrapara,1440361,717814,722547,1089265,579970,509295,438243,466890,322265,144625,1006.5936301047346,75.62,80.8,70.49
ORISSA,Jagatsinghapur,1136971,577865,559106,889027,481049,407978,352732,403649,290170,113479,967.5374006039473,78.19,83.25,72.97
ORISSA,Cuttack,2624470,1352760,1271710,2011469,1103033,908436,790297,936365,696274,240091,940.0854549217895,76.64,81.54,71.43
ORISSA,Jajapur,1827192,926034,901158,1290455,706396,584059,541139,552234,407564,144670,973.1370554428887,70.63,76.28,64.81
ORISSA,Dhenkanal,1192811,612593,580218,829910,464093,365817,352369,435533,277338,158195,947.1508815804294,69.58,75.76,63.05
ORISSA,Anugul,1273821,655718,618103,869456,494425,375031,414587,526520,317547,208973,942.6354011938058,68.26,75.4,60.67
ORISSA,Nayagarh,962789,502636,460153,688362,392333,296029,288334,343633,229076,114557,915.4795915931211,71.5,78.06,64.33
ORISSA,Khordha,2251673,1167137,1084536,1749936,957515,792421,688729,792193,632625,159568,929.2276742147666,77.72,82.04,73.07
ORISSA,Puri,1698730,865380,833350,1291939,704857,587082,474224,621676,450536,171140,962.987358154799,76.05,81.45,70.45
ORISSA,Ganjam,3529031,1779218,1749813,2210050,1262652,947398,1015394,1501772,900744,601028,983.4730763740025,62.62,70.97,54.14
ORISSA,Gajapati,577817,282882,294935,262537,153663,108874,175145,293933,170371,123562,1042.6078718334852,45.44,54.32,36.91
ORISSA,Kandhamal,733110,359945,373165,399786,233900,165886,242935,355349,167112,188237,1036.7278334189946,54.53,64.98,44.45
ORISSA,Baudh,441162,221625,219537,271612,158648,112964,137954,219457,123724,95733,990.5786802030458,61.57,71.58,51.46
ORISSA,Subarnapur,610183,311312,298871,398421,230393,168028,193502,286661,170218,116443,960.0368761885182,65.3,74.01,56.22
ORISSA,Balangir,1648997,830097,818900,927260,545672,381588,538962,720601,402227,318374,986.5112149543969,56.23,65.74,46.6
ORISSA,Nuapada,610382,301962,308420,299383,180903,118480,209127,305438,151694,153744,1021.3867970141939,49.05,59.91,38.42
ORISSA,Kalahandi,1576869,787101,789768,802036,484177,317859,494748,751930,376757,375173,1003.3883834476134,50.86,61.51,40.25
ORISSA,Rayagada,967911,471960,495951,407735,241959,165776,286548,467122,227815,239307,1050.8326976862445,42.13,51.27,33.43
ORISSA,Nabarangapur,1220946,604812,616134,470379,286984,183395,372264,610906,279115,331791,1018.7198666693121,38.53,47.45,29.77
ORISSA,Koraput,1379647,678809,700838,568090,340843,227247,460128,693406,396460,296946,1032.4524277079415,41.18,50.21,32.43
ORISSA,Malkangiri,613192,303624,309568,244706,147001,97705,183723,310666,179030,131636,1019.5768450451874,39.91,48.42,31.56
CHHATTISGARH,Koriya,658917,334737,324180,397823,229923,167900,181615,307071,173057,134014,968.4618073293361,60.38,68.69,51.79
CHHATTISGARH,Surguja,2359886,1193129,1166757,1187941,694686,493255,590763,1155807,622589,533218,977.8967739448124,50.34,58.22,42.28
CHHATTISGARH,Jashpur,851669,424747,426922,495415,280656,214759,226392,487360,291349,196011,1005.1206953786607,58.17,66.08,50.3
CHHATTISGARH,Raigarh,1493984,750278,743706,951639,542756,408883,420916,690167,484875,205292,991.240580158288,63.7,72.34,54.98
CHHATTISGARH,Korba,1206640,612915,593725,748759,433391,315368,332653,521186,350314,170872,968.6906014700244,62.05,70.71,53.12
CHHATTISGARH,Janjgir - Champa,1619707,815717,803990,1019634,593679,425955,440773,846466,461887,384579,985.6236905691558,62.95,72.78,52.98
CHHATTISGARH,Bilaspur,2663629,1351574,1312055,1596560,932474,664086,737806,1203197,826568,376629,970.7607574576012,59.94,68.99,50.61
CHHATTISGARH,Kabeerdham,822526,412058,410468,414167,248503,165664,211179,404156,316976,87180,996.1413199112746,50.35,60.31,40.36
CHHATTISGARH,Rajnandgaon,1537133,762855,774278,1008379,561355,447024,390132,800092,595959,204133,1014.974012099285,65.6,73.59,57.73
CHHATTISGARH,Durg,3343872,1682101,1661771,2303378,1284612,1018766,883189,1496805,1206793,290012,987.9139243125115,68.88,76.37,61.31
CHHATTISGARH,Raipur,4063872,2048186,2015686,2629749,1493158,1136591,1068500,1757664,1259138,498526,984.1323004844287,64.71,72.9,56.39
CHHATTISGARH,Mahasamund,1032754,511967,520787,637963,364089,273874,310567,499260,340802,158458,1017.2276728773535,61.77,71.12,52.59
CHHATTISGARH,Dhamtari,799781,397897,401884,546833,303924,242909,210481,402895,335368,67527,1010.0201811021445,68.37,76.38,60.44
CHHATTISGARH,Uttar Bastar Kanker,748941,373338,375603,456042,258298,197744,194069,389359,285536,103823,1006.0668884496087,60.89,69.19,52.65
CHHATTISGARH,Bastar,1413199,698487,714712,650863,382335,268528,371319,726531,394824,331707,1023.2287787746945,46.06,54.74,37.57
CHHATTISGARH,Narayanpur,139820,70104,69716,56621,33449,23172,33095,71089,42056,29033,994.4653657423257,40.5,47.71,33.24
CHHATTISGARH,Dakshin Bastar Dantewada,533638,264142,269496,191237,116529,74708,137849,286595,184285,102310,1020.2694005497044,35.84,44.12,27.72
CHHATTISGARH,Bijapur,255230,128663,126567,86919,54076,32843,58391,134525,69338,65187,983.7093803191283,34.06,42.03,25.95
MADHYA PRADESH,Sheopur,687861,361784,326077,328025,208201,119824,176522,277455,196189,81266,901.3029874179068,47.69,57.55,36.75
MADHYA PRADESH,Morena,1965970,1068417,897553,1179685,747652,432033,414586,675993,520970,155023,840.0774229537717,60.01,69.98,48.13
MADHYA PRADESH,Bhind,1703005,926843,776162,1094917,676513,418404,359596,520768,422111,98657,837.4255402479168,64.29,72.99,53.91
MADHYA PRADESH,Gwalior,2032036,1090327,941709,1357210,803114,554096,444892,685311,559845,125466,863.6941027783408,66.79,73.66,58.84
MADHYA PRADESH,Datia,786754,420157,366597,491445,303815,187630,203854,321160,247229,73931,872.5238422780056,62.46,72.31,51.18
MADHYA PRADESH,Shivpuri,1726050,919795,806255,900846,573242,327604,434618,759281,577723,181558,876.5594507471774,52.19,62.32,40.63
MADHYA PRADESH,Tikamgarh,1445166,760355,684811,747940,459353,288587,382992,655318,470432,184886,900.6464085854634,51.75,60.41,42.14
MADHYA PRADESH,Chhatarpur,1762375,936121,826254,943033,572010,371023,470917,751797,553862,197935,882.6358985643949,53.51,61.1,44.9
MADHYA PRADESH,Panna,1016520,533480,483040,552559,332140,220419,288923,431998,276633,155365,905.451000974732,54.36,62.26,45.63
MADHYA PRADESH,Sagar,2378458,1256257,1122201,1545719,908607,637112,613915,1006035,779093,226942,893.2893508255079,64.99,72.33,56.77
MADHYA PRADESH,Damoh,1264219,661873,602346,747715,445737,301978,369901,574595,389993,184602,910.0628066109359,59.14,67.34,50.13
MADHYA PRADESH,Satna,2228935,1157495,1071440,1371781,801051,570730,576004,911349,612510,298839,925.6541064972203,61.54,69.21,53.27
MADHYA PRADESH,Rewa,2365106,1225100,1140006,1441757,845572,596185,618399,991946,630251,361695,930.5411803118113,60.96,69.02,52.3
MADHYA PRADESH,Umaria,644758,330674,314084,356672,210907,145765,168066,289691,138600,151091,949.829741679116,55.32,63.78,46.41
MADHYA PRADESH,Neemuch,826067,422653,403414,508834,307889,200945,242197,418682,358500,60182,954.4803893501288,61.6,72.85,49.81
MADHYA PRADESH,Mandsaur,1340411,682851,657560,834591,502898,331693,384119,679723,535066,144657,962.9626375300029,62.26,73.65,50.44
MADHYA PRADESH,Ratlam,1455069,738241,716828,825880,485090,340790,373867,690980,471139,219841,970.9945668149019,56.76,65.71,47.54
MADHYA PRADESH,Ujjain,1986864,1016289,970575,1240990,730817,510173,489449,897442,682115,215327,955.0187003893577,62.46,71.91,52.56
MADHYA PRADESH,Shajapur,1512681,780520,732161,894612,543509,351103,386608,717871,508833,209038,938.0425869932866,59.14,69.63,47.95
MADHYA PRADESH,Dewas,1563715,805359,758356,925369,550716,374653,376009,742676,528526,214150,941.6372077545542,59.18,68.38,49.4
MADHYA PRADESH,Dhar,2185793,1112725,1073068,1077338,638479,438859,515712,1027974,783019,244955,964.3604664225213,49.29,57.38,40.9
MADHYA PRADESH,Indore,3276697,1699627,1577070,2309130,1289631,1019499,788318,1268195,1137251,130944,927.8918256770456,70.47,75.88,64.65
MADHYA PRADESH,Khargone (West Nimar),1873046,953121,919925,986234,575428,410806,460163,894119,756735,137384,965.1712636695655,52.65,60.37,44.66
MADHYA PRADESH,Barwani,1385881,699340,686541,549926,313642,236284,299270,653897,525791,128106,981.6984585466296,39.68,44.85,34.42
MADHYA PRADESH,Rajgarh,1545814,790212,755602,804245,488797,315448,401717,745603,471773,273830,956.201626905185,52.03,61.86,41.75
MADHYA PRADESH,Vidisha,1458875,769568,689307,862918,512344,350574,376409,550402,397283,153119,895.7064223044617,59.15,66.58,50.86
MADHYA PRADESH,Bhopal,2371061,1236130,1134931,1660690,920314,740376,700719,867457,706036,161421,918.1323970779772,70.04,74.45,65.24
MADHYA PRADESH,Sehore,1311332,683743,627589,780362,469208,311154,329647,586087,372150,213937,917.872650981436,59.51,68.62,49.58
MADHYA PRADESH,Raisen,1331597,700358,631239,820220,479093,341127,325713,517838,370241,147597,901.3090448028008,61.6,68.41,54.04
MADHYA PRADESH,Betul,1575362,799236,776126,939769,529783,409986,406649,786980,511287,275693,971.0848860661932,59.65,66.29,52.82
MADHYA PRADESH,Harda,570465,294838,275627,352550,203807,148743,144559,230979,163781,67198,934.8421845216695,61.8,69.13,53.97
MADHYA PRADESH,Hoshangabad,1241350,648725,592625,810644,469199,341445,315396,478082,361648,116434,913.5226791013141,65.3,72.33,57.62
MADHYA PRADESH,Katni,1292042,662013,630029,790773,460583,330190,349031,543874,316144,227730,951.6867493538647,61.2,69.57,52.41
MADHYA PRADESH,Jabalpur,2463289,1277278,1186011,1756468,980307,776161,624761,1005624,744287,261337,928.5457042241392,71.31,76.75,65.44
MADHYA PRADESH,Narsimhapur,1091854,568810,523044,718785,413491,305294,283718,477818,358203,119615,919.5407956962782,65.83,72.69,58.37
MADHYA PRADESH,Dindori,704524,351913,352611,378714,222759,155955,227795,389925,250137,139788,1001.9834447718612,53.75,63.3,44.23
MADHYA PRADESH,Mandla,1054905,525272,529633,604962,348033,256929,316932,559649,325159,234490,1008.3023652507652,57.35,66.26,48.51
MADHYA PRADESH,Chhindwara,2090922,1064468,1026454,1294198,731294,562904,553944,957984,673845,284139,964.2882641845504,61.9,68.7,54.84
MADHYA PRADESH,Seoni,1379131,695879,683252,864194,485341,378853,382587,684434,397575,286859,981.8546040331724,62.66,69.75,55.45
MADHYA PRADESH,Balaghat,1701698,842178,859520,1147623,626468,521155,470867,893014,530506,362508,1020.5918463792689,67.44,74.39,60.63
MADHYA PRADESH,Guna,1241519,649362,592157,653980,400537,253443,285085,514897,353671,161226,911.9058398859188,52.68,61.68,42.8
MADHYA PRADESH,Ashoknagar,845071,443837,401234,469109,290304,178805,206741,315270,241288,73982,904.0120584809288,55.51,65.41,44.56
MADHYA PRADESH,Shahdol,1066063,540021,526042,604194,348761,255433,291440,493057,240811,252246,974.1139696419214,56.68,64.58,48.56
MADHYA PRADESH,Anuppur,749237,379114,370123,436595,254120,182475,207713,346471,227040,119431,976.2841783737873,58.27,67.03,49.3
MADHYA PRADESH,Sidhi,1127033,575912,551121,600785,353030,247755,276869,461760,275482,186278,956.9534928947478,53.31,61.3,44.95
MADHYA PRADESH,Singrauli,1178273,613637,564636,585054,359923,225131,287325,499439,348393,151046,920.1466013294505,49.65,58.65,39.87
MADHYA PRADESH,Jhabua,1025048,515023,510025,352081,214582,137499,235793,515121,370641,144480,990.2955790323928,34.35,41.66,26.96
MADHYA PRADESH,Alirajpur,728999,362542,366457,209754,120905,88849,150528,366797,265029,101768,1010.7987488346178,28.77,33.35,24.25
MADHYA PRADESH,Khandwa (East Nimar),1310061,674329,635732,731615,432259,299356,329088,612976,492393,120583,942.7623608060753,55.85,64.1,47.09
MADHYA PRADESH,Burhanpur,757847,388504,369343,408679,233073,175606,178840,328339,274900,53439,950.6800444783065,53.93,59.99,47.55
GUJARAT,Kachchh,2092371,1096737,995634,1252319,739239,513080,739275,776228,686937,89291,907.8147267758816,59.85,67.4,51.53
GUJARAT,Banas Kantha,3120506,1610379,1510127,1704923,1048402,656521,804197,1248600,1012080,236520,937.7463317641375,54.64,65.1,43.47
GUJARAT,Patan,1343734,694397,649337,837913,494631,343282,404138,554830,446240,108590,935.1091666582661,62.36,71.23,52.87
GUJARAT,Mahesana,2035064,1056520,978544,1502645,847499,655146,659743,812064,698768,113296,926.1954340665582,73.84,80.22,66.95
GUJARAT,Sabar Kantha,2428589,1244231,1184358,1578734,918625,660109,665533,1084878,795096,289782,951.8795143345569,65.01,73.83,55.74
GUJARAT,Gandhinagar,1391753,723864,667889,1030494,582686,447808,433258,534976,451951,83025,922.6719383751644,74.04,80.5,67.05
GUJARAT,Ahmadabad,7214225,3788051,3426174,5435760,3025463,2410297,2198552,2594952,2332409,262543,904.4688152297844,75.35,79.87,70.35
GUJARAT,Surendranagar,1756268,909917,846351,1093626,643221,450405,500598,723500,586364,137136,930.1408809814523,62.27,70.69,53.22
GUJARAT,Rajkot,3804558,1974445,1830113,2725056,1514075,1210981,1181006,1479050,1324783,154267,926.8999642937636,71.63,76.68,66.17
GUJARAT,Jamnagar,2160119,1114192,1045927,1396534,795140,601394,646325,847440,721253,126187,938.7313856139697,64.65,71.36,57.5
GUJARAT,Porbandar,585449,300209,285240,393678,221621,172057,183572,231169,195437,35732,950.1380704775672,67.24,73.82,60.32
GUJARAT,Junagadh,2743082,1404356,1338726,1842818,1046981,795837,776743,1123709,942709,181000,953.2668354747657,67.18,74.55,59.45
GUJARAT,Amreli,1514190,771049,743141,995459,558180,437279,430613,657139,529153,127986,963.805153758062,65.74,72.39,58.84
GUJARAT,Bhavnagar,2880365,1490201,1390164,1887255,1087371,799884,744077,1150632,992140,158492,932.8701295999667,65.52,72.97,57.54
GUJARAT,Anand,2092745,1087224,1005521,1551253,874481,676772,621987,844794,690031,154763,924.8517324856699,74.13,80.43,67.31
GUJARAT,Kheda,2299885,1185727,1114158,1660243,942480,717763,622026,933983,722134,211849,939.6412496299739,72.19,79.49,64.42
GUJARAT,Panch Mahals,2390776,1226961,1163815,1440805,858054,582751,567601,1097507,685141,412366,948.5346315001048,60.27,69.93,50.07
GUJARAT,Dohad,2127086,1068651,1058435,1007171,599035,408136,376504,999124,553395,445729,990.4402840590614,47.35,56.06,38.56
GUJARAT,Vadodara,4165626,2153736,2011890,2893080,1614087,1278993,1240425,1693473,1360660,332813,934.1395602803686,69.45,74.94,63.57
GUJARAT,Narmada,590297,301086,289211,370336,211767,158569,160369,294795,193916,100879,960.5594414884783,62.74,70.33,54.83
GUJARAT,Bharuch,1551019,805707,745312,1118276,623047,495229,481996,627124,526541,100583,925.0409888458211,72.1,77.33,66.45
GUJARAT,The Dangs,228291,113821,114470,140968,77314,63654,59618,118257,88038,30219,1005.7019354952075,61.75,67.93,55.61
GUJARAT,Navsari,1329672,678165,651507,1001909,539471,462438,409156,591834,510004,81830,960.6909822830727,75.35,79.55,70.98
GUJARAT,Valsad,1705678,887222,818456,1170657,655528,515129,498391,743245,577327,165918,922.4929048197633,68.63,73.89,62.94
GUJARAT,Surat,6081322,3402224,2679098,4571410,2687468,1883942,1899838,2553542,2405288,148254,787.4549118458984,75.17,78.99,70.32
GUJARAT,Tapi,807022,402188,404834,490036,269007,221029,218489,450902,337579,113323,1006.5790127999841,60.72,66.89,54.6
DAMAN AND DIU,Diu,52074,25642,26432,38058,20327,17731,18850,15750,14718,1032,1030.808829264488,73.08,79.27,67.08
DAMAN AND DIU,Daman,191173,124659,66514,150348,104316,46032,71079,105521,101717,3804,533.5675723373362,78.64,83.68,69.21
DADRA AND NAGAR HAVELI,Dadra AND Nagar Haveli,343709,193760,149949,223230,142521,80709,108783,157161,130299,26862,773.8903798513626,64.95,73.56,53.82
MAHARASHTRA,Nandurbar,1648295,833170,815125,906509,512099,394410,405012,792065,664193,127872,978.3417549839769,55.0,61.46,48.39
MAHARASHTRA,Dhule,2050862,1054031,996831,1293916,723388,570528,528790,936370,825875,110495,945.7321463979712,63.09,68.63,57.23
MAHARASHTRA,Jalgaon,4229917,2197365,2032552,2891882,1629223,1262659,1169788,1863571,1643955,219616,924.9951646631306,68.37,74.14,62.12
MAHARASHTRA,Buldana,2586258,1337560,1248698,1879874,1048892,830982,728192,1219641,1107542,112099,933.5641017973026,72.69,78.42,66.55
MAHARASHTRA,Akola,1813906,932334,881572,1411281,758977,652304,504235,768154,691025,77129,945.553846582877,77.8,81.41,73.99
MAHARASHTRA,Washim,1197160,620302,576858,869917,487703,382214,330846,569792,502755,67037,929.9631469832436,72.67,78.62,66.26
MAHARASHTRA,Amravati,2888445,1480768,1407677,2251875,1207104,1044771,781815,1236322,1061544,174778,950.639803129187,77.96,81.52,74.22
MAHARASHTRA,Wardha,1300774,668385,632389,1019458,552617,466841,388704,608235,529623,78612,946.1448117477203,78.37,82.68,73.82
MAHARASHTRA,Nagpur,4653570,2384975,2268595,3673808,1959220,1714588,1308366,1868560,1654778,213782,951.2028427970944,78.95,82.15,75.58
MAHARASHTRA,Bhandara,1200334,605520,594814,899860,488709,411151,356418,597305,413838,183467,982.3193288413264,74.97,80.71,69.12
MAHARASHTRA,Gondiya,1322507,661554,660953,1004243,542837,461406,386515,665419,433962,231457,999.0915329663187,75.93,82.05,69.81
MAHARASHTRA,Gadchiroli,1072942,541328,531614,708365,395110,313255,330840,584237,392886,191351,982.0552419235657,66.02,72.99,58.93
MAHARASHTRA,Chandrapur,2204307,1123834,1080473,1578615,872565,706050,684655,1058172,804433,253739,961.4168996488805,71.62,77.64,65.35
MAHARASHTRA,Yavatmal,2772348,1419965,1352383,2022574,1115980,906594,798132,1355999,1195100,160899,952.4058691587469,72.96,78.59,67.04
MAHARASHTRA,Nanded,3361292,1730075,1631217,2189425,1255222,934203,821682,1493953,1317791,176162,942.8591246044247,65.14,72.55,57.27
MAHARASHTRA,Hingoli,1177345,606294,571051,790743,450551,340192,284369,569182,514371,54811,941.8714353102621,67.16,74.31,59.57
MAHARASHTRA,Parbhani,1836086,942870,893216,1157814,666291,491523,427239,822797,756417,66380,947.3373847932377,63.06,70.67,55.03
MAHARASHTRA,Jalna,1959046,1011473,947573,1195523,699428,496095,502830,930886,844492,86394,936.8248089667248,61.03,69.15,52.35
MAHARASHTRA,Aurangabad,3701282,1924469,1776813,2503837,1430936,1072901,979132,1575079,1446636,128443,923.2744201127687,67.65,74.35,60.38
MAHARASHTRA,Nashik,6107187,3157186,2950001,4345366,2397538,1947828,1668932,2763328,2523023,240305,934.3766886081467,71.15,75.94,66.03
MAHARASHTRA,Thane,11060148,5865078,5195070,8227161,4591396,3635765,3618151,4492767,3930511,562256,885.7631560910188,74.39,78.28,69.98
MAHARASHTRA,Mumbai Suburban,9356962,5031323,4325639,7575485,4223029,3352456,3078829,3735021,3515922,219099,859.741861136723,80.96,83.93,77.5
MAHARASHTRA,Mumbai,3085411,1684608,1400803,2509022,1410680,1098342,1107321,1284396,1209334,75062,831.53054004255,81.32,83.74,78.41
MAHARASHTRA,Raigarh,2634200,1344345,1289855,1939994,1059692,880302,959028,1072969,858825,214144,959.4672498502988,73.65,78.83,68.25
MAHARASHTRA,Pune,9429408,4924105,4505303,7171723,3940210,3231513,3222457,4048993,3751221,297772,914.9486048733729,76.06,80.02,71.73
MAHARASHTRA,Ahmadnagar,4543159,2342825,2200334,3151890,1773355,1378535,1323404,2204590,2039455,165135,939.1798363087298,69.38,75.69,62.65
MAHARASHTRA,Bid,2585049,1349106,1235943,1718507,987185,731322,698571,1255548,1154708,100840,916.1200083610925,66.48,73.17,59.17
MAHARASHTRA,Latur,2454196,1273140,1181056,1650672,932432,718240,585632,1046857,964177,82680,927.6717407355043,67.26,73.24,60.81
MAHARASHTRA,Osmanabad,1657576,861535,796041,1137810,644304,493506,444990,773916,701894,72022,923.9798731334189,68.64,74.79,62.0
MAHARASHTRA,Solapur,4317756,2227852,2089904,2910676,1651266,1259410,1156231,1898395,1763175,135220,938.080267450441,67.41,74.12,60.26
MAHARASHTRA,Satara,3003741,1510842,1492899,2225694,1201034,1024660,975471,1354947,1184407,170540,988.1238408781329,74.1,79.49,68.64
MAHARASHTRA,Ratnagiri,1615069,761121,853948,1199392,619012,580380,639362,714076,554973,159103,1121.9608971503874,74.26,81.33,67.96
MAHARASHTRA,Sindhudurg,849651,417332,432319,666067,348289,317778,340836,347178,226538,120640,1035.9114565861234,78.39,83.46,73.51
MAHARASHTRA,Kolhapur,3876001,1980658,1895343,2825845,1559760,1266085,1179314,1704054,1508563,195491,956.9259306755634,72.91,78.75,66.8
MAHARASHTRA,Sangli,2822143,1435728,1386415,2049467,1121550,927917,853673,1215104,1074948,140156,965.6529649070019,72.62,78.12,66.93
ANDHRA PRADESH,Adilabad,2741239,1369597,1371642,1483347,856350,626997,817714,1323667,1066460,257207,1001.4931399528475,54.11,62.53,45.71
ANDHRA PRADESH,Nizamabad,2551335,1250641,1300694,1389810,790214,599596,720298,1261076,1055965,205111,1040.0218767815863,54.47,63.18,46.1
ANDHRA PRADESH,Karimnagar,3776269,1880800,1895469,2206829,1257238,949591,1165280,1876768,1590304,286464,1007.7993407060826,58.44,66.85,50.1
ANDHRA PRADESH,Medak,3033288,1523030,1510258,1637137,953406,683731,789132,1442203,1195494,246709,991.6140850803989,53.97,62.6,45.27
ANDHRA PRADESH,Hyderabad,3943323,2018575,1924748,2892155,1542688,1349467,1066289,1413297,1096081,317216,953.5181997200996,73.34,76.42,70.11
ANDHRA PRADESH,Rangareddy,5296741,2701008,2595733,3538028,1948784,1589244,1561322,2196078,1834777,361301,961.0238103700544,66.8,72.15,61.23
ANDHRA PRADESH,Mahbubnagar,4053028,2050386,2002642,1940646,1158386,782260,1010015,2082501,1815643,266858,976.7146283675366,47.88,56.5,39.06
ANDHRA PRADESH,Nalgonda,3488809,1759772,1729037,2001019,1160757,840262,1030937,1741693,1493419,248274,982.5346692639728,57.36,65.96,48.6
ANDHRA PRADESH,Warangal,3512576,1759281,1753295,2065023,1179790,885233,1046987,1705655,1442197,263458,996.5974736270101,58.79,67.06,50.49
ANDHRA PRADESH,Khammam,2797370,1390988,1406382,1630234,901640,728594,870625,1410062,1215871,194191,1011.0669538486314,58.28,64.82,51.81
ANDHRA PRADESH,Srikakulam,2703114,1341738,1361376,1495381,857824,637557,902436,1290288,936244,354044,1014.6362404582713,55.32,63.93,46.83
ANDHRA PRADESH,Vizianagaram,2344474,1161477,1182997,1238388,707503,530885,749514,1157962,953215,204747,1018.5281327137774,52.82,60.91,44.88
ANDHRA PRADESH,Visakhapatnam,4290589,2138910,2151679,2568249,1422878,1145371,1379340,1889879,1481139,408740,1005.9698631545974,59.86,66.52,53.23
ANDHRA PRADESH,East Godavari,5154296,2569688,2584608,3288577,1716933,1571644,1605841,2093681,1748117,345564,1005.8061523422299,63.8,66.81,60.81
ANDHRA PRADESH,West Godavari,3936966,1964918,1972048,2652389,1379223,1273166,1255628,1773112,1534166,238946,1003.6286501523219,67.37,70.19,64.56
ANDHRA PRADESH,Krishna,4517398,2267375,2250023,3009718,1598959,1410759,1476334,2048880,1744978,303902,992.347097414411,66.63,70.52,62.7
ANDHRA PRADESH,Guntur,4887813,2440521,2447292,2960441,1634726,1325715,1582990,2381624,2106326,275298,1002.7744075957552,60.57,66.98,54.17
ANDHRA PRADESH,Prakasam,3397448,1714764,1682684,1904435,1107686,796749,1087575,1700567,1463508,237059,981.2918862304084,56.05,64.6,47.35
ANDHRA PRADESH,Sri Potti Sriramulu Nellore,2963557,1492974,1470583,1832189,1011922,820267,953513,1314561,1076544,238017,985.0024179925438,61.82,67.78,55.78
ANDHRA PRADESH,Y.S.R.,2882469,1451777,1430692,1716766,994699,722067,884093,1320404,1079903,240501,985.4764195878569,59.56,68.52,50.47
ANDHRA PRADESH,Kurnool,4053463,2039227,2014236,2127161,1246369,880792,1090835,2029425,1757520,271905,987.7448660693489,52.48,61.12,43.73
ANDHRA PRADESH,Anantapur,4081148,2064495,2016653,2310960,1338474,972486,1244428,2036166,1679655,356511,976.8262940816035,56.63,64.83,48.22
ANDHRA PRADESH,Chittoor,4174064,2090204,2083860,2667878,1484794,1183084,1303870,1933357,1669852,263505,996.9648895514505,63.92,71.04,56.77
KARNATAKA,Belgaum,4779661,2423063,2356598,3052032,1725548,1326484,1318975,2105668,1734501,371167,972.5698423854435,63.85,71.21,56.29
KARNATAKA,Bagalkot,1889752,950111,939641,1113412,641388,472024,490657,818081,676407,141674,988.9802349409701,58.92,67.51,50.23
KARNATAKA,Bijapur,2177331,1111022,1066309,1248268,730566,517702,527490,927722,760083,167639,959.755072356803,57.33,65.76,48.55
KARNATAKA,Bidar,1703300,870665,832635,1042673,597198,445475,389403,702608,551763,150845,956.320743339861,61.21,68.59,53.5
KARNATAKA,Raichur,1928812,964511,964301,979769,577213,402556,455848,903413,725985,177428,999.7822730896796,50.8,59.85,41.75
KARNATAKA,Koppal,1389920,699926,689994,809085,468785,340300,337649,654766,508089,146677,985.8099284781534,58.21,66.98,49.32
KARNATAKA,Gadag,1064570,537147,527423,700177,397178,302999,291972,495722,423451,72271,981.8969481352405,65.77,73.94,57.45
KARNATAKA,Dharwad,1847023,937206,909817,1301664,711776,589888,483104,784833,690948,93885,970.7759019895306,70.47,75.95,64.84
KARNATAKA,Uttara Kannada,1437169,726256,710913,1081906,582099,499807,474792,608526,498304,110222,978.8738406291995,75.28,80.15,70.3
KARNATAKA,Haveri,1597668,819128,778540,1085443,603793,481650,413564,730066,601951,128115,950.4497465597562,67.94,73.71,61.87
KARNATAKA,Bellary,2452595,1236954,1215641,1421621,813440,608181,623480,1116880,969388,147492,982.7697715517311,57.96,65.76,50.03
KARNATAKA,Chitradurga,1659456,840843,818613,1087392,607188,480204,447348,856587,667479,189108,973.5622464598029,65.53,72.21,58.66
KARNATAKA,Davanagere,1945497,986400,959097,1308540,720637,587903,530691,875207,705099,170108,972.3205596107056,67.26,73.06,61.3
KARNATAKA,Shimoga,1752753,877415,875338,1263016,674938,588078,554106,780598,652789,127809,997.6328191334774,72.06,76.92,67.18
KARNATAKA,Udupi,1177361,562131,615230,926429,465704,460725,385389,513241,459446,53795,1094.4601881056194,78.69,82.85,74.89
KARNATAKA,Chikmagalur,1137961,566622,571339,818345,438257,380088,392426,565774,480229,85545,1008.324773835114,71.91,77.35,66.53
KARNATAKA,Tumkur,2678980,1350594,1328386,1813391,1006024,807367,890242,1354646,1078431,276215,983.5568646092015,67.69,74.49,60.78
KARNATAKA,Bangalore,9621551,5022661,4598890,7512276,4078041,3434235,3267960,4246927,3858342,388585,915.6281899176552,78.08,81.19,74.68
KARNATAKA,Mandya,1805769,905085,900684,1149649,638668,510981,562302,871408,714901,156507,995.1374732759907,63.67,70.56,56.73
KARNATAKA,Hassan,1776421,883667,892754,1225256,668836,556420,628981,903580,752387,151193,1010.2832854457617,68.97,75.69,62.33
KARNATAKA,Dakshina Kannada,2089649,1034714,1054935,1666323,864019,802304,650292,997721,914476,83245,1019.542598244539,79.74,83.5,76.05
KARNATAKA,Kodagu,554519,274608,279911,412877,215302,197575,212974,278938,258753,20185,1019.311163549496,74.46,78.4,70.58
KARNATAKA,Mysore,3001127,1511600,1489527,1962180,1063766,898414,920982,1314268,1082108,232160,985.3975919555438,65.38,70.37,60.32
KARNATAKA,Chamarajanagar,1020791,512231,508560,565279,312957,252322,319880,481693,381408,100285,992.833311533273,55.38,61.1,49.61
KARNATAKA,Gulbarga,2566326,1301755,1264571,1427368,828359,599009,600007,1087028,844237,242791,971.435485171941,55.62,63.63,47.37
KARNATAKA,Yadgir,1174271,590329,583942,510003,306751,203252,262995,547696,437241,110455,989.1806094567605,43.43,51.96,34.81
KARNATAKA,Kolar,1536401,776396,760005,1016219,564110,452109,477609,717872,584590,133282,978.8883507900607,66.14,72.66,59.49
KARNATAKA,Chikkaballapura,1255104,636437,618667,783222,442158,341064,409702,639778,535565,104213,972.0789331858456,62.4,69.47,55.13
KARNATAKA,Bangalore Rural,990923,509172,481751,688749,385311,303438,326462,459891,389989,69902,946.1458996174181,69.51,75.67,62.99
KARNATAKA,Ramanagara,1082636,548008,534628,674758,378461,296297,351784,531459,458841,72618,975.5842980394447,62.33,69.06,55.42
GOA,North Goa,818008,416677,401331,663060,351738,311322,325089,327658,269437,58221,963.1705133712684,81.06,84.42,77.57
GOA,South Goa,640537,322463,318074,502427,264085,238342,251493,249590,206616,42974,986.3891361179423,78.44,81.9,74.93
LAKSHADWEEP,Lakshadweep,64473,33123,31350,52553,28023,24530,21242,18753,10804,7949,946.4722398333483,81.51,84.6,78.25
KERALA,Kasaragod,1307375,628613,678762,1037492,516476,521016,417805,462998,372700,90298,1079.7772238245154,79.36,82.16,76.76
KERALA,Kannur,2523003,1181446,1341557,2138434,1012956,1125478,872479,824116,694209,129907,1135.5212172202537,84.76,85.74,83.89
KERALA,Wayanad,817420,401684,415736,645585,328136,317449,277988,340077,263445,76632,1034.9827227372762,78.98,81.69,76.36
KERALA,Kozhikode,3086293,1470942,1615351,2615443,1266939,1348504,990336,948981,754187,194794,1098.1745031415242,84.74,86.13,83.48
KERALA,Malappuram,4112920,1960328,2152592,3311315,1597404,1713911,1157129,1062424,852047,210377,1098.0774645875588,80.51,81.49,79.62
KERALA,Palakkad,2809934,1359478,1450456,2239492,1122600,1116892,894341,1042340,875540,166800,1066.9212741949484,79.7,82.58,77.0
KERALA,Thrissur,3121200,1480763,1640437,2678548,1282261,1396287,1051867,1095727,929506,166221,1107.8322459434764,85.82,86.59,85.12
KERALA,Ernakulam,3282388,1619557,1662831,2855676,1425723,1429953,1174691,1249343,1061388,187955,1026.7196523493772,87.0,88.03,86.0
KERALA,Idukki,1108974,552808,556166,923010,471881,451129,412433,516363,415947,100416,1006.0744417591641,83.23,85.36,81.11
KERALA,Kottayam,1974551,968289,1006262,1749798,861592,888206,678161,735735,604553,131182,1039.2165975240864,88.62,88.98,88.27
KERALA,Alappuzha,2127789,1013142,1114647,1852797,890552,962245,723536,804471,596387,208084,1100.1883250324238,87.08,87.9,86.33
KERALA,Pathanamthitta,1197412,561716,635696,1062553,499181,563372,472840,392794,293257,99537,1131.703565502852,88.74,88.87,88.62
KERALA,Kollam,2635375,1246968,1388407,2240273,1074345,1165928,925130,912025,695299,216726,1113.426326898525,85.01,86.16,83.98
KERALA,Thiruvananthapuram,3301427,1581678,1719749,2785408,1354857,1430551,1169117,1231669,921282,310387,1087.2940004223365,84.37,85.66,83.18
TAMIL NADU,Thiruvallur,3728104,1876062,1852042,2791721,1495711,1296010,1119433,1538054,1247918,290136,987.1965851874832,74.88,79.73,69.98
TAMIL NADU,Chennai,4646732,2335844,2310888,3776276,1968079,1808197,1314125,1817297,1619554,197743,989.3160673401135,81.27,84.26,78.25
TAMIL NADU,Kancheepuram,3998252,2012958,1985294,3013382,1611461,1401921,1213504,1673814,1367378,306436,986.2570406337339,75.37,80.05,70.62
TAMIL NADU,Vellore,3936331,1961688,1974643,2773928,1504355,1269573,1140300,1689330,1360185,329145,1006.6040063455555,70.47,76.69,64.29
TAMIL NADU,Tiruvannamalai,2464875,1235889,1228986,1626813,909803,717010,710163,1238177,970072,268105,994.4145469374677,66.0,73.62,58.34
TAMIL NADU,Viluppuram,3458873,1740819,1718054,2195776,1234479,961297,967314,1703249,1260802,442447,986.9228219590894,63.48,70.91,55.95
TAMIL NADU,Salem,3482056,1781571,1700485,2285562,1285107,1000455,1170352,1694160,1561030,133130,954.4862371468777,65.64,72.13,58.83
TAMIL NADU,Namakkal,1726601,869280,857321,1176131,653312,522819,627484,898245,839152,59093,986.2426375851279,68.12,75.16,60.98
TAMIL NADU,Erode,2251744,1129868,1121876,1492662,828300,664362,843684,1195773,1111051,84722,992.9266073559036,66.29,73.31,59.22
TAMIL NADU,The Nilgiris,735394,360143,375251,569647,299447,270200,264105,349974,318924,31050,1041.9500031931761,77.46,83.15,72.01
TAMIL NADU,Dindigul,2159775,1080938,1078837,1481834,816180,665654,713542,1105155,963017,142138,998.0563177536546,68.61,75.51,61.7
TAMIL NADU,Karur,1064493,528184,536309,727044,401726,325318,364661,543298,508507,34791,1015.3828968692728,68.3,76.06,60.66
TAMIL NADU,Tiruchirappalli,2722290,1352284,1370006,2038981,1087765,951216,875727,1213979,1082329,131650,1013.1052352908116,74.9,80.44,69.43
TAMIL NADU,Perambalur,565223,282157,283066,375823,208011,167812,188592,299726,255097,44629,1003.2216106635667,66.49,73.72,59.28
TAMIL NADU,Ariyalur,754894,374703,380191,480604,269582,211022,254277,359851,272241,87610,1014.6462665097424,63.67,71.95,55.5
TAMIL NADU,Cuddalore,2605914,1311697,1294217,1815281,1000322,814959,758209,1169880,837271,332609,986.6737516362391,69.66,76.26,62.97
TAMIL NADU,Nagapattinam,1616450,798127,818323,1213008,640916,572092,517740,671994,486328,185666,1025.3042435602354,75.04,80.3,69.91
TAMIL NADU,Thiruvarur,1264277,626693,637584,946471,503085,443386,408179,540168,412425,127743,1017.378525051341,74.86,80.28,69.54
TAMIL NADU,Thanjavur,2405890,1182416,1223474,1790998,944264,846734,753372,974079,834484,139595,1034.7238197047402,74.44,79.86,69.21
TAMIL NADU,Pudukkottai,1618345,803188,815157,1110545,608776,501769,503941,761693,640248,121445,1014.9018660637361,68.62,75.79,61.55
TAMIL NADU,Sivaganga,1339101,668672,670429,959744,526304,433440,452417,620171,461102,159069,1002.6275961906586,71.67,78.71,64.65
TAMIL NADU,Madurai,3038252,1526475,1511777,2273430,1223810,1049620,1010441,1354632,1173902,180730,990.3712802371477,74.83,80.17,69.43
TAMIL NADU,Theni,1245899,625683,620216,870080,479403,390677,410623,591642,530591,61051,991.2623485055532,69.84,76.62,62.99
TAMIL NADU,Virudhunagar,1942288,967709,974579,1398788,760375,638413,734724,950158,854066,96092,1007.0992416108562,72.02,78.57,65.51
TAMIL NADU,Ramanathapuram,1353445,682658,670787,978946,536487,442459,417239,602977,486150,116827,982.610619080125,72.33,78.59,65.96
TAMIL NADU,Thoothukkudi,1750176,865021,885155,1349697,703106,646591,636739,748095,657447,90648,1023.2757355023751,77.12,81.28,73.05
TAMIL NADU,Tirunelveli,3077233,1520912,1556321,2273457,1210710,1062747,1064667,1436454,1271407,165047,1023.2814258813132,73.88,79.6,68.29
TAMIL NADU,Kanniyakumari,1870374,926345,944029,1548738,780541,768197,598041,679620,552658,126962,1019.090079829869,82.8,84.26,81.37
TAMIL NADU,Dharmapuri,1506843,774303,732540,917709,527599,390110,487926,751170,652996,98174,946.0637502373102,60.9,68.14,53.25
TAMIL NADU,Krishnagiri,1879809,960232,919577,1187958,667062,520896,580540,877779,742001,135778,957.6612735255646,63.2,69.47,56.65
TAMIL NADU,Coimbatore,3458045,1729297,1728748,2635907,1394790,1241117,1169752,1567950,1443252,124698,999.682529952923,76.23,80.66,71.79
TAMIL NADU,Tiruppur,2479052,1246159,1232893,1760566,959623,800943,894908,1266137,1168596,97541,989.3544884721773,71.02,77.01,64.96
PONDICHERRY,Yanam,55626,27301,28325,39274,19919,19355,15519,16760,15373,1387,1037.5077835976706,70.6,72.96,68.33
PONDICHERRY,PONDICHERRY,950289,468258,482031,726649,380946,345703,291037,348105,315570,32535,1029.41327217047,76.47,81.35,71.72
PONDICHERRY,Mahe,41816,19143,22673,36470,16610,19860,12110,11802,10404,1398,1184.4016089432168,87.22,86.77,87.59
PONDICHERRY,Karaikal,200222,97809,102413,154916,79903,75013,69333,68301,58342,9959,1047.071332903925,77.37,81.69,73.25
ANDAMAN AND NICOBAR ISLANDS,Nicobars,36842,20727,16115,25332,15397,9935,15958,17125,9651,7474,777.4883002846528,68.76,74.28,61.65
ANDAMAN AND NICOBAR ISLANDS,North  AND Middle Andaman,105597,54861,50736,78683,43186,35497,40185,38579,31038,7541,924.8099742986822,74.51,78.72,69.96
ANDAMAN AND NICOBAR ISLANDS,South Andaman,238142,127283,110859,190266,105794,84472,85532,96831,85221,11610,870.9647007063002,79.9,83.12,76.2
